ivanka trump	juniors ivanka trump sweater 
ivanka trump	ivanka trump handbags 
logmein123.com	remote desktop support 
senior housing	sunrise senior living 
faroe island	faroe islands hotels 
nice france	things to do nice france 
panaca nevada	panaca hotels 
google	google employment 
usbank.com	personal checking accounts 
friv	new super mario bros 
craigslist	craigslist job post 
ln	chile airlines 
bbt.com	online bank account 
outlook	microsoft office outlook 
ivanka trump	juniors ivanka trump sweaters 
pokemon game	nintendo ds games 
youtube	youtube music video promotion 
microsoft.com	microsoft.com office 
google	in google adwords 
oo	what is a amazon 
arvest	online bank account 
youtube	the best of youtube videos 
td bank	td checking account 
pga tour	pga tour leaderboard 
bugatti veyron	volkswagen bugatti veyron 
face	login 
california	directions mapquest 
booloo	boo boo loon 
google	google earth 
nyse	nyse stock trading 
vienna austria	visit vienna 
tdbank.com	online bank account 
workforcenow.adp.com	payroll service 
craigslist	craigslist jobs 
marketwatch	what is the stock market 
friv	secure file sharing 
liteblue.usps.gov	employee payroll services 
calculator	prudential retirement planner 
destin florida	hotel destin 
wellsfargo.com	online bank account 
sumdog	game design program 
bb t.com	online bank account 
turkey	travel in turkey 
dollar tree	dollar tree careers 
dollar tree	dollar tree employment 
turkey	thanksgiving turkey 
hawaii	resort in hawaii 
logmein123.com	pc remote support software 
friv	ben10 toy 
nice france	visit nice france 
nice france	westminster hotel nice 
burger king	job application 
google	google adwords about 
womens clothing	sundresses for women 
clothing	plus size jumpsuits 
spanish to english translation	buy rosetta stone 
gps	directions mapquest 
zara	clothing for women 
nice	hotel in nice 
fashion	fashion dresses 
veneers	new teeth veneers 
pinterest	pinterest home ideas 
chase.com	chase online banking 
investment advisor	registered investment advisor representative 
airstream	airstream rv trailers 
md	medical web md 
nice france	nice france things to do 
treasurydirect.gov	us government bonds 
indeed jobs new jobs	free job posting 
internet service provider	time warner cable internet 
cheesecake factory	groupon.com 
designer handbag	burberry handbags crossbody 
جوجل google search عربي	name search 
ana	american nurse 
conversion calculator	international currency transfer 
vinelink	county jail inmate lookup 
urgent care near me	closest urgent care 
cheap internet service	time warner cable internet 
nice france	what to see in nice france 
nice france	what to do in nice france 
europe	european vacations 
union bank of california	online bank account 
japan	hotel in japan 
.com	kitchenaid appliances 
myql	quicken online 
gate 1 travel	groupons 
wic	wic nutrition program 
xxl	big and tall clothing 
xxl	big mens clothing 
wcco	wcco weather radar 
anywho.com white pages	people search 
clothing	big and tall shirts 
abcya 5th grade	math for 5th grade 
dollar store	o stock 
abcy	game design program 
boeing	boeing seattle 
myhealth.va.gov login	military records 
ivivva	athletica 
water parks near me	hotels with indoor water parks 
dex	dex reverse phone lookup 
mcu	mcu credit card 
bbandt.com	online bank account 
kingsizedirect.com	big mens clothing 
cnn	cnn news on tv 
outlook.com	microsoft office outlook 
craigslist	craigslist houses 
epic	epic medical system 
clint eastwood	clint eastwood poster 
paint	paintzoom com 
mta	amtrak schedule 
employeeconnection.net	macys 
jamaica	all inclusive vacations packages 
oo	amizon 
marilyn monroe	juniors marilyn monroe tops 
kalahari ohio water park	groupon 
citigroup	citigroup credit card 
paychex flex	paychecks payroll service 
cheap internet	time warner cable internet 
sunsplash roseville	golfland sunsplash hotel 
route 66	route 66 warranty 
region	personal checking accounts 
east west bank	east west bank home loan 
kizi	bingo game 
rc car	micro rc cars 
lowes	home improvement 
meijer	meijer application 
personals	compare dating services 
regions.com	personal checking accounts 
portable hot tub	spa hot tub pump 
nice france	nice france voyage 
boohoo	haute look coupon 
hy	hyundai price 
cheap internet service	internet access provider 
impetigo	impetigo rash pictures 
virginia court case information	free criminal court records search 
microsoft	microsoft office support 
nord	nordstrom dresses 
mail	yahoo e mail com 
unionbank.com	online bank account 
logmein123.com	remote access to computer 
eyemedvisioncare.com	vision coverage 
ivanka trump	ivanka trump bags 
seacoast national bank	personal checking accounts 
dollar tree	career dollar tree 
santander consumer usa	santander loan 
paris	cheap ticekts paris 
womens clothes	sundresses for women 
google feud	play family feud online 
nickelodeon	nickelodeon suites resort in orlando fl 
microsoft	microsoft help 
cheap vinyl flooring	vinyl floor 
aafes	military star credit card 
verizon phone number	verizon htc one 
calculator free	school calculator online 
craigslist.org	craigslist jobs 
chameleon	chameleon enclosure 
detroit	detroit travel 
blackrock	blackrock mutual funds 
flatware	the webstauarnt store 
forever	forever 21 clothing 
pornmd	watch for free movies online 
malibustrings.com	bikinis 
google	what is google ad words 
moneynetwork.com	online payroll company 
analytic	marketing analytics 
huntington.com	huntington bank offers 
seattle washington	seattle hotels 
ggg	dresses girls 
hernando county property appraiser	commercial property records 
filehippo	ccleaner 
dumbo	dumbo walking tour 
intranet	what is intranet 
webster bank	webster bank checks 
icloud.com	login icloud email 
amica	amica insurance quote 
brevard county property appraiser	property tax assessments 
habitat	rabbit habitat 
palm beach post	palm beach florida 
america	americas best eyeglasses 
ask jeeves a question for free	how to invest in stocks online 
santander	santander loans 
calvin klein jacket	calvin klein blazer 
adp portal	automated payroll service 
chip	chip health insurance 
woman clothing	sundresses for women 
td bank	bank checking account 
waterloo	waterloo canada hotels 
craigs list	craigslist job post 
aol mail	e mail 
mcdonalds	mcdonalds employment 
exercise equipment	the pullup systems 
nextmd.com	online patient portal 
tennessee titans	tennessee titans football tickets 
us bank	online bank account 
garden stakes	clearance garden statue 
lazy boy furniture gallery	gallery furniture store 
cypress college	cypress college class schedule 
lily	lily baby clothes 
microsoft download	download microsoft office 
korea	south korea tourism 
tcc	tarrant county college arlington 
ghostbusters movie	ghostbusters poster 
boohoo	casual dresses 
brewers	brewers tickets 
party	party invitations 
hobo bag	hobo bags sale 
bakeware supply	bakeware sets 
kitten	kitten food 
geico.com	car insurance 
manatee county property appraiser	commercial property records 
express clothing	cocktail dresses 
apple.com	apple store support 
the great escape	great escape patio furniture 
lo	lowes stores 
friv 4	top game design schools 
88sears	employee payroll services 
drf	racing form entries 
vited	vintage clothing 
psychotherapist	what is a psychotherapist 
bachmann trains	coupon for hobby lobby 
trec	texas realtor license 
inflation	what is inflation 
transmission repair houston	car transmission repair 
global	global furniture office 
panaca nevada	hotel near panaca 
kk	l 
tg	transformation digest 
slimming belt	weight belts 
hh	helly hansen foul weather gear 
heritage house	booking the heritage house resort 
google search	peoplesearch 
citimortgage online payment	citimortgage refinance 
oklahoma	directions mapquest 
investment calculator	retirement income calculator 
filehippo	chrome browser 
cold brew coffee	how to make cold coffee 
burger king	burger king career opportunities 
southwest	airlines tickets 
microsoft	microsoft office technical support 
humana.com myhumana	humana provider directory 
white dining room set	dining set 
current news	nytimes subscription 
egg salad sandwich recipe	egg recipes 
internet truckstop	truck freight loads 
club penguin	buy gummy penguins 
canadian pharcharmy online	helprx 
icloud login	login icloud email 
learn spanish	rosetta stone pricing 
accounting	accountant course 
popcorn machine	the webstauarnt store 
boston news	the boston globe 
torrid	plus size lingerie 
home investment loan	investment home loans 
familysearch.org free	genealogy 
baby buggy stroller	baby carriage stroller 
gas station	gasoline stations 
noodles and company	noodles delivery 
bryce harper	bryce harper t shirt 
arlington national cemetery	military cemeteries 
shirt	cheap t shirts 
rpr	rpr real estate 
magnifying glass	big vision 
now	now supplements 
antibiotic	generic antibiotics 
channel 2	channel 2 weather 
cheapest cable and internet package	at t uverse 
ohio business gateway	ohio business gateway pay sales tax 
learn english	rosetta stone 
turp	prostate surgery turp 
craiglist	craigslist job post 
mega	the mega millions 
pants	chefpants 
amgen	amgen stock 
purse	mini purses 
ross dress for less	lace dresses 
land for sale	bank owned properties listings 
french flag	chad flag 
gold value	rosland gold 
directv pay bill	online payment services 
t shirt company	t shirts for sale 
francia	esplendor plaza francia 
tom brady	tom brady quarterback 
sedro woolley wa	hotels sedro woolley 
minecraft demo	quickbooks online demo 
total reward harrahs	harrahs total rewards card 
mvp	mvp health insurance 
pbskids.com	cheap square shape trampoline 
hotel near space needle	space needle hotels 
router	router tech support 
help wanted	job post 
53	online bank account 
us bank.com	personal checking accounts 
bmx bike part	bmx kid bike 
palm beach state college	palm beach community college website 
pokemon trading card game online	trading online 
coastal carolina university	coastal carolina university online 
home decor wall art	wall decor 
dominica	dominica tourism 
xda	android developers forum 
great clip	great clips hair cut 
usaa.com log on to my account	usaa checking account 
ks	bliss fat 
keybak	key bank loan rates 
solar powered led light	solar powered landscaping lights 
missguided	midi dresses 
dollar store	walgreens ad 
rapid city journal	rapid city sd lodging 
sony alpha a6000	a6000 sony 
.org	geneology.com 
apd	courses for payroll certification 
toolbars for google chrome	google toolbar free download 
crbauto.com	my auto loan 
anaylitics	marketing analytics 
antelope canyon	antelope canyon guided tours 
denali	dealership gmc 
ferret	ferret cage 
home depot ess	employee payroll services 
optimum email	email login 
chipotle	chipotle application 
canada 411	411 business directory 
4 bedroom house for rent	real estate rent to own homes 
3x	big and tall clothing 
market watch	what is the stock market 
benz truck	benz 
outdoor fire pit tool	fire pit outdoor 
streaming	tv streaming sites 
fiji	tourism in fiji 
southwest	cheap airfares 
media shopping	the home goods 
learning spanish	rosetta stone pricing 
sneaker for man	puma sneakers 
oakland airport	oakland airport parking lots 
zara	womens plus size clothing 
ferret	ferret cages 
logmein123.com	remote support 
joggers	international roguefitness 
sdf	sdf rental car 
mexico	mexico tourism 
craigslist.com local community	the apartment 
fruit	order sour apple fruit slices 
creditkarma.com credit score	how do you fix your credit score 
sunsplash	sunsplash vacation homes 
tops	tunic tops 
bank america online banking sign	online banking from bank of america 
gy	jvc gy hm150u 
afdah	download movie 
herbs	growing herbs 
environmental	environmental schools 
espn3	espn3 internet providers 
zz	american musical supplies 
stardool	girls dress 
wholesale pencil	personalized pencils 
greendot.com register new card	register green dot visa card 
brewhouse	the brewhouse inn milwaukee 
comcast.net	home xfinity 
habbo hotel	hotel 
black owned banks	list of black owned banks 
annalytics	marketing analytics 
shopping	macys super sales 
manatee county clerk of court	public court records search 
nice france	nice france attractions 
military diet	3 day refresh 
solar battery	solar backup battery 
lincare	lincare cpap 
estubview employee portal	employee payroll services 
sod	sod landscaping 
tn.gov	department of motor vehicles 
bart	amtrak travel 
game	nintendo ds game 
t mobile	t mobile cell phones 
logmein123.com	remote access it support 
opossum	opossum control 
evolve.elsevier.com	evolve elsevier exam 
mole	mole pest removal 
hotel lodo denver	lodo hotels 
steel fire pit	buy fire pit 
la jolla bed and breakfast	what to do in la jolla 
canadian pharcharmy online	viagra prescription coupon 
lll	la leche 
new smartphone	smartphone compare 
warped tour	vans warped tour tickets 
2 bedroom house for rent	rent to own 
man watch box	watch boxes men 
za	crocs sandals 
utah vacation	all inclusive vacations packages 
free translation	translate services 
cro asia	visit croatia 
hybrid camry	camry hybrid cars 
finland	finland tourism 
hcc	houston community college online 
scion dealer near me	scion 
cardiologist	find a cardiologist 
upstart	upstart loans 
solar panel kit	best solar panels 
simple wedding dress	dresses for weddings guest 
esprit	easy spirt womens sneakers 
dartmouth college	dartmouth college online 
craigs list	craigslist jobs 
gre	gre general test 
patio cover	best patio covers 
suitcase	storewide clearance events 
organic essential oil	wholesale organic essential oils 
hotmail.com	email list of 
applying for financial aid	financial aid application 
sw airline	airlines 
westin maui	westin kaanapali ocean resort villas 
mortgage rate jumbo loan	jumbo mortgage rates 
ksl classifieds utah idaho wyo	ksl used cars in utah 
hendrick honda	hendrick honda used cars 
dune buggy	nellis dune buggy 
fancy pants	jm collection pants 
ibc.com	online bank account 
pavers	masonry pavers 
bjs.com wholesale club	bjs tire sale 
30 year jumbo loan rate	30 year jumbo 
donation pickup	give to vets 
hotel chain	hotel near 
coventry health	coventry health ins 
oil change	oil changes near me 
london los angeles	london west hollywood 
cal poly	california state polytechnic university 
linksys	linksys wireless router setup 
wisconsin circuit court	public court records 
fast.com	go to assist 
optimum.net	what is cable tv 
recyclebank	recycling rewards program 
hotel near the space needle	space needle hotels 
motorcycle trailer for sale	ramps for motorcycles 
ada	ada compliance guidelines 
logo design services	logo services 
craiglist	craigslist jobs 
ny daily news	daily news paper 
xe currency converter	forex currency exchange 
cnc	cnc machine school 
bug out bag	blackhawk s.o.f carrying bag 
totalrewards.com	harrahs ac 
jet ski	jet ski purchase 
adpvantage.adp.com	paycheck payroll service 
massage envy	groupon 
hhh	hilton head airport car rentals 
maxpreps	maxpreps basketball 
lucky	lucky brand sandals 
8 person hot tub	hot tub pump 
pepsi	pepsi job search 
girl game	baby girl dresses 
ii	kids ii 
ask.com search engine	questions about cars repair 
express	express shipping 
irs scams	irs tax relief scams 
pilot house key west	key west guesthouse 
homework assignment	homework assignment book 
clothes	jessica simpson girls coats 
auctionzip.com	property auction 
weather	weather station 
merrickbank.com login	merritt credit card 
bunk bed with desk	adjustable bed frame 
route 66 map	mapquest directions 
craigs list	classified ads online 
astoria bank	online bank account 
hotel spa package	hotel packages 
craigslist rochester ny	used cars in rochester ny 
palottery.com	lottery result.com 
2nd swing golf	preowned taylormade clubs 
tulsa raceway park	hotels near raceway park 
caremark.com	silverscript 
imax	imax furniture 
turkey	tourism in turkey 
menopause	menopause advice 
stardol	girls dress 
walk in clinic	walk in medical clinics 
beaumont enterprise	enterprise car rentals beaumont ca 
metro pcs customer service	metro pcs phone service 
hotel near sports authority field	sports authority field hotels 
sunpass	accountnow 
craigslist fayetteville nc	used cars in fayetteville 
nelnet.com manage my account	lower my student loan payments 
verizon central web mail	email login 
wild things	wild things curtains 
dayz map	maps and driving directions 
custom baseball t shirt	custom t shirts 
dollar tree	careers dollar tree 
psychotherapy	what is a psychotherapist 
education benefit for military spouse	education for military spouses 
designer bedroom furniture	modern bedroom furniture 
heinz	heinz mustard 
kizi	oral b kids 
viet nam	travel to vietnam 
leather messenger bag	cheap leather messenger bags 
job site	free job sites 
ftcc	community college fayetteville nc 
ricardo	ricardo trading curtains 
analitics	marketing analytics 
indian springs	indian springs nv hotel 
ozark trail outdoor equipment	mountain hardwear 
restoration hardware catalog	hardware restoration 
kona hawaii	kona resort 
conservator	what is conservatorship 
seterus	seterus loan modification 
hunting chair	camo hunting chair 
harris teeter	harris teeter apply 
adsense	adsense income 
analitycs	marketing analytics 
bar	home bar furniture stores 
electric man	local electrician 
scion auto	scion 
comed	comed payment center 
swim wear for woman	swimwear sets 
wedding shoes	shoes for wedding 
mctc	minneapolis technical and community college 
expedia	travel expedia 
wilton	hobby lobby coupon 40 off 
yum	kfc yum center hotel 
eye exam	where to get an eye exam 
fleet farm	mills fleet farm tires 
you tube	youtube music video promotion 
analyti	marketing analytics 
vaporizors	amaaon 
analyticcs	marketing analytics 
boot store	corral cowboy boots 
celtics	boston celtics tickets 
analyctics	marketing analytics 
analyticsa	marketing analytics 
condolences	sample words of sympathy 
gymshark	rogue fitness 
allison	alison courses online 
4th of july sales	storewide clearance events 
dryer	sears stackable washer dryers 
zombieland	zombieland the movie 
san francisco	floral delivery in 94154 
prwc.adp.com	employee payroll services 
chinchilla	best chinchilla cage 
menards online store menards store	menards outdoor furniture 
kohls credit	girls tank 
analyticd	marketing analytics 
custom jersey	logo team sportswear 
bnp	bnp heart failure test 
adpportal	paycheck payroll service 
allpar	allpar chrysler 
wish	sexy tops 
dawn detergent coupon	laundry detergent coupons 
verizon central	email login 
shabby chic decorating idea	shabby cottage chic decor 
southwest	air lines 
centurylink bill pay	centurylink phone service 
pokemon game	nintendo ds game 
crude oil	stock market crude oil 
caravan tour costa rica	day tours costa rica 
analyitcs	marketing analytics 
white top	womens anne klein tops 
chemise sleepwear	linea donatella womens chemises 
scion suv	scion 
kroger	kroger online application 
table rock lake	table rock lake lodging 
duke	university duke 
onedrive	microsoft office cloud 
analytcis	marketing analytics 
analyticals	marketing analytics 
gateway bible	online bible studies 
catos	plus size fashions 
anaylics	marketing analytics 
time	subscribe ny times 
cape cod hotel deal	hotel cape cod 
geranium	the pink geranium pontardawe 
install google	install google chrome 
wellsfargo.com	wells fargo checking 
ana	ana airline 
craiglist	classified ads online 
lake compounce	lake compounce discounts 
firstmerit banking online	online bank account 
pet friendly hotel vermont	pet friendly hotels 
channel art	design banner online 
white furniture	ashley furniture store 
modells	sporting goods 
direct tv total choice package	direct tv package 
ace	ace cash loans 
best product for stretch marks	best stretch mark cream pregnancy 
barcelona spain	barcelona cruises 
benchmark	benchmark tests 
steinhafels	furniture stores 
couch	connie furniture 
thalassemia	what is thalassemia disease 
kid loft bed with desk	loft bed desk 
leadership style	leadership online course 
internet and phone bundle	internet phone package 
maps.google.com	driving directions 
nationstarmtg.com	national home mortgage 
croatia	visit croatia 
ground zero	ground zero tour 
youtube.com	tub and shower 
us bank	us bank loan payment 
ocharleys	ocharleys restaurant menu 
adopt a kitten	animal cruelty charities 
efirstbank.com	online bank account 
google search	people searches 
washington state map	mapquest directions 
dkny sandal	dkny jeans 
luxury villas for rent	armeni villas 
capacitor	capacitor air conditioner 
my ql	quicken online 
buycrash.com	police report online 
analetics	marketing analytics 
dealerconnect	dodge chrysler dealer 
deductible	deductible insurance 
cdg	rental car cdg airport 
seafood	seafood delivery 
indoor bicycle trainer	freestrider 
indonesia	indonesia vacation 
pace bus	megabus routes 
tuesday morning	home goods 
seamless bra	seamless minimizer bra 
lean six sigma certification online	six sigma online certification 
national wholesale liquidators	lumberliquidatorsdirectory.com 
qt	quiktrip job 
zucchini	easy zucchini recipes 
patio furniture cushion cover	best patio furniture covers 
shotgun	`amazon 
rci	rci membership 
microsoft	microsoft support 
aetna	aetna health care 
student portal	itt student portal online classes 
torrid.com	trendy plus size 
labcorp.com	patient appointment scheduling 
psp	psp movies 
iphone 6 apple case	iphone6 cover 
internet service	time warner internet 
wedding frame	wedding picture frame 
medieval times dallas	groupon 
weed eater trimmer	work weed eater 
avi	avi resort casino laughlin 
straw hat	western straw hats 
lexus is 250 cost	lexus is 
ibiza	ibiza spain hotels 
ma	maceys com 
librium	librium alcohol withdrawal 
rhapsody.com	rhapsody music player 
nickelodeon	nickelodeon resort 
odcr	search court records 
zip fizz	walgreens shop 
peoplesbancorp.com	online bank account 
allrecipes.com	slow cooker recipes 
topsail beach nc	oceanfront viking motel 
old lahaina luau	old lahaina house 
iphone 7	buy iphone 6 
linksys router	linksys router support 
percocet	percocet addiction 
current price of gold	rosland gold 
opelika auburn newspaper	auburn opelika 
express	levis jean 
beirut	beirut tour 
internet services	time warner cable internet 
housing for rent	rent2own 
philadelphia pa	philadelphia attractions 
cz	1058wf cz 
decorative outdoor string light	outdoor string party lights 
online mba health care	healthcare online mba 
daisy fuentes	daisy fuentes hair extensions 
craigslist hudson valley	hudson valley lighting 
mchenry county circuit clerk	public court records 
duffle bag	travel duffel bag 
greece	traveling greece 
black storage bench	black indoor bench 
rainierland	freeon line movies 
ireland	airfare to ireland 
hotel in surfside beach sc	surfside beach hotels 
mesa community college	mesa community college online 
phlox	phlox flowers 
k2 drug	k2 side effects 
marshall	macy one day sale 
meijer	meijers grocery store ads 
mcdvoice.com	create a survey online 
vinyl record storage	record lp storage 
quick	quickbook com 
dress up who	girls dress 
sight and sound	sight sound branson 
hydronephrosis	what is hydronephrosis 
garden accessory	garden statue 
how to tile a backsplash	backsplash 
turkey	turkey fry 
industrial metal shelf	industrial wall shelves 
torrid	plus size bathing suit 
connecticut car insurance	car insurance connecticut 
principal	principal life insurance company 
rash	diseases that cause skin rashes 
pitera	what is pitera ingredient 
cheap tennis ball	penn tennis ball 
beaver	hotel beaver 
triple bunk bed for sale	blue bunk beds 
nj transit train schedule	amtrak travel 
hotel surfside beach sc	surfside beach hotels 
army	join the military 
toyota sienna lease special	lease toyota sienna 
lorex	home security services 
cummins	diesel cummins 
foreclosure help	home foreclosure help 
hcc	hcc online course 
baby alive	baby alive accessories 
casual clothing	casual dresses 
ruby tuesday	ruby tuesday career 
hotel near ontario airport	ontario airport hotels 
myfordbenefits.com	my ford benefits 
wholesale diamond engagement ring	engagement rings wholesale 
heating and cooling system	heating and cooling ducts 
kings	1 kings lane online 
paracord	hobby lobby coupon 40 
wel	online checking account 
requirement for financial aid	students financial aid 
bee balm	perennial bee balm 
branson resort	stillwaters resort branson 
summer classics	summer classics patio 
venezuela	travel to venezuela 
the beatles	beatles story 
craigslist kansas city	find used cars 
patio furniture outdoor	outdoor patio furniture 
travel insurance usa	usa travel insurance 
raspberry	growing raspberry plants 
solar water fountain	lawn water fountains 
wheel well tool box	dee zee wheel well tool box 
uae	united arab emirates tourism 
data entry	cheap data entry 
outdoor wedding dress	guest of wedding dresses 
pono	pono kai condos 
new scion	scion new 
volcano national park	kona volcano night tour 
escambia county clerk of court	court record 
resort in cabo	cabo resorts 
rainbow	rainbow black flip flop 
santander bank	santander business credit card 
cool backpack	school backpacks 
woman s clothing	sundresses for women 
bugatti	volkswagen bugatti 
daily devotional	daily devotional guide 
usb memory stick	usb memory wholesale 
arthroscopy	left knee arthroscopy 
balsa wood	40 hobby lobby coupon 
ham radio outlet	new ham radio equipment 
downtown detroit hotel	hotel near detroit downtown 
mamba	mamba online dating 
canning tomato	coupon for tomato sauce 
electrician near me	electricians in my area 
earn to die	online classes 
raymour and flanigan clearance center	furniture clearance 
wzzo	zoom 
gwinnett county schools	college in gwinnett county 
berghoff cookware	the webstauarnt store 
cuba	all inclusive family vacations 
luxury house for rent	luxury vacation home rentals 
utmb	utmb nurse practitioner program 
downtown indy hotel	hotel indianapolis indiana 
easy	fill in work cited page 
naproxen	apo naproxen 
costco.com	costco tires deals 
cheap laminate flooring	vinyl floor 
corrugated metal roofing	roofing prices 
adopt a pet	pet adoption ads 
napa auto part	napa auto parts careers 
man carpenter jeans	carhartt carpenter jean 
ftb	online bank savings account 
exxonmobil	exxon mobil gas credit card 
colors	paint color 
adsense	adsense money 
pine	big pines mountain house hotel 
tablet review	latest tablet reviews 
cna	cna training 
roses discount store	discount home goods 
vision	vision plan 
sumdog.com	game design program 
best thermogenic fat burner	best diet pill 
bank of hawaii online e bankoh	personal checking accounts 
chafing dish	thewebstaurantstore com 
tops	strapless tops 
iihs	kia 
linux operating system	linux hardware 
outlook live	outlook.com 
nut	spicy nut 
samba vw	classic vw parts 
ups tracking by tracking number	shipment services 
implant	full dental implants 
compactor	best trash compactor 
ivanka trump	ivanka trump dresses 
geico.om	car insurance 
bbandt	bbandt loans 
slim patch	slim weight loss patch 
dish rv	rv sat dish 
bc	travelodge salmon arm switsemalph 7 british columbia 
grammar	grammar rules 
merrick credit login	merrick bank account 
regionsbank.com	personal checking accounts 
tapestry	large golf canvas 
cert	cert training online 
planetromeo	gay dating website 
fifththirdbank.com login	on line bank accounts 
nice france	things to do in nice france 
rv camper	camper rv sales 
macys	michael by michael kors 
natural laundry detergent	laundry detergent natural 
hobby lobby	arts craft stores in nashville tn 
upscale menswear	belvedere shoes 
battle.net	blizzard entertainment 
hotel near seattle space needle	space needle hotels 
immediate annuity	lifetimeincome nylaarp 
dr phil	dr phil drug rehab 
live stock market ticker	e trading 
hancock fabric	sewing fabric 
catamaran	catamaran waikiki 
jobs hiring	free job posting 
hong kong	hong kong best vacations packages 
soccer gloves	adidas soccer goalkeeping glove 
southwest	discount airfare 
hotel near seattle child hospital	seattle childrens hospital hotels 
acer	acer laptop support 
one piece	one piece bathing suits 
shenandoah	shenandoah hotels 
choke collar	dog choke collar 
shelving	furniture stores 
snacks	best snacks 
glassware	the webstauarnt store 
denim romper	womens rompers and jumpsuits 
craigslist santa barbara	resort in santa barbara 
lenskart	discountcontactlenses 
tmobile	t mobile cell phones 
scratch	scratch cat 
knickers	ladies knickers 
ameritrade client login	ameritrade stocks 
ups tracking by tracking number	next day shipping 
splashback	backsplash ideas 
voice live	tv streaming sites 
accounting	accounting class 
turtles	turtle supplies 
bearded dragon care	bearded dragon starter kit 
praying mantis for sale	praying mantis eggs 
sprint	sprint cellular phone 
bgsu	bowling green state university tuition 
listerine	cool mint listerine 
how to sell on amazon	how to start selling on amazon 
palermo	palermo tourism 
corset	corset dresses 
turkey	natural turkey 
blue ridge parkway map	mapquest directions 
oil prices	oil prices stock 
earthlink.net	earthlink toll free number 
walmart.com	walmart online shopping 
rats	controlling rats 
system	security systems 
qvc.com recently on air	clarks shoes shops 
herzing blackboard	herzing university online 
zofran	zofran pregnancy category 
lm	vintage linoleum 
cardiff	cardiff tourism 
dow jones industrial average history	dow jones index history chart 
costa rica trip	costa rica day trips 
duncanhines.com	duncan hines recipes 
marbella	hotel in marbella 
tokyo hotel	hotel in tokyo 
npu login	northwest polytechnic university 
smart tv	samsung 55 smart tv 
ring	wood gymnastics ring 
grizzly jacks grand bear resort	grizzly bear lodge hotel cody 
koi fish	koi fish food bulk 
gaf	gaf roofing system 
xxi	juniors clothing 
bare foot running shoes	running shoes for flat feet 
tunisia	tunisia all inclusive 
astoria oregon	hotel near astoria oregon 
ipay.adp.com	adp payroll services 
mcdonalds	mcdonalds near me 
pet friendly hotel in mackinaw city	hotels mackinaw city 
rfid	rfid passport wallets 
hydrocortisone cream	walgreens official site 
ml	merrill lynch 401k 
eye exam	best eye exams 
gilroy garden	hotels in gilroy 
handbag	hobo handbags 
creed	creed cologne for men 
trulia	trulia home values 
kizi	free online bingo 
behringer powered speaker	speaker behringer 
accordion door	room dividers 
tallest building in the world	burj khalifa in dubai 
mobile internet	vehicle wifi hotspot 
porn md	watch for free movies online 
soft serve ice cream machine	the webstauarnt store 
seal beach ca	hotel near seal beach 
vessel tracking	gps fleet tracking devices 
shark rotator	shark vacuum rotator 
solar security light with motion sensor	motion security light 
high arch running shoes	running shoes for flat feet 
online shopping	nordstrom dresses 
gm financial	walmart job application 
wholesale k cup	k cups tea 
financial aid requirement	students financial aid 
payday loan	payday loan online 
back country magazine	backcountry 
djia	djia average 
thejigsawpuzzles.com	jigsaw 
overseas travel insurance	medical insurance overseas 
airport	airport hotel rate 
five star credit union	five star credit card 
camper rental	cheap rental passenger van 
jobgateway.pa.gov	monster jobs 
internet and tv bundle	tv internet bundles 
rbc royal bank online banking	online bank account 
solar panel work	solar panels for sale 
mmi	mmi debt consolidation 
ny	ny time subscription 
garden planner	space planning software 
best vinyl plank flooring	plank vinyl 
recession	definition of recession 
out	microsoft office outlook 
assurion	asurion extended warranty 
auction	house in auction 
citimortgage	citibank mortgages 
newport news	newport swims 
easton baseball pants	easton jacket 
bikini swimsuit	womens bikini swimsuits 
tcf bank	tcf bank in milwaukee 
boy robe	mens robes 
foscam	foscam security cameras 
okapi	okapi rooms rome 
las vegas airport map	las vegas airport taxi 
media chest	espresso chest 
call option	call option trading 
police academy requirement	police academy application 
weight lifting gloves	bodybuilders 
jlab	math sol practice 
best 35mm slide scanner	slide scanners 35mm 
les schwab tire center	les schwab tire deals 
things to do in naples	naples hotel 
garden waterfall	small backyard waterfalls 
xvidios	watch movies online free 
body mass index	calculate body mass 
rbc.com	online bank account 
diversity in the workplace	diversity in the workplace training 
cockroach	what kills cockroaches 
long sleeve romper	white romper 
culvers	culvers job 
lemon law	lemon law help 
pointe hilton tapatio cliffs resort	pointe hilton phoenix 
the hartford.com	the hartford play on business insurance 
cloning	genetic cloning 
wm.com	wm dumpster 
outlook email	microsoft office cost 
dogloo	dog igloo house 
undergraduate	undergraduate study 
plus size beach wedding dress	beach wedding gown 
ocwencustomers.com	ocwen mortgage rates 
gm al	gmail 
gerbil	large gerbil cage 
central florida toyota	toyota central 
wunderground.com weather	noaa weather radar 
22 magnum pistol	walther talon magnum 22 
pillar candle holder	pillar holder 
outdoor kitchen idea	outdoor kitchen set 
mypillow.com	tempurpedic pillow 
solar panel sales	wholesale solar equipment 
tab top drape	tab top curtains drapes 
respite	adult respite care 
idlewild park	idlewild park hotels 
crime	neighborhood crime 
caterpillar	caterpillar boots 
seattle hotel near pier 91	seattle cruise port hotel 
jovani dress	pink dresses 
luxury home for rent	luxury vacation home rentals 
allied insurance	allied home insurance 
martini	best martini 
cat training	cat training book 
analytis	marketing analytics 
swimming pool coping	swimming pool set 
couch for sale	storewide clearance events 
beadboard	wholesale old growth floors 
utah resort	homestead resort midway 
husband	my husband is 
kid tablet	best kids tablet 
bathroom tile design	bathroom design tile 
fahrenheit	fahrenheit thermometer 
how much is a toyota corolla	corolla 
portal.office.com	microsoft office professional 2010 
chelsea fc	chelsea fc schedule 
i9 form	federal ein numbers 
my ebay sign in user id	ebay buying 
kid loft bed with slide	loft bed slide 
federal application for student aid	fafsa online form 
danby freezer	sears kenmore upright freezers 
uber partner and driver	uber car requirements 
crude oil prices	oil futures trading 
vh	how can i watch tv online 
redspot tv korean drama	watch korean tv drama 
aetna health fund	aetna insurance florida 
analyt	marketing analytics 
rodd	ross home decor 
fnb.com	online bank account 
usana product review	usana review 
vacation rental in miami	miami vacation rentals 
hotel near pikes peak	pikes peak hotels 
river plate	river plate stadium hotel 
auto nation	autonation dealerships 
exxon	exxon gas card 
jeans for man	best mens jeans 
management information system major	major in information systems 
cpr training	cpr training course 
western inn	old town western inn 
guinea pig	guinea pig habitat 
entity	entities definition 
pool filter	sta rite pool filters 
mobile dog groomer	grooming brush for dog 
acls online certification	acls online 
environmental engineer	environmental studies online 
asperger	treatment for aspergers 
rothco	rothco clothing 
bible gateway	college of bible 
semper fi	marine semper fi 
queen victoria	the queen victoria bed breakfast 
trinidad newsday	trinidad trinidad and tobago 
maverik.com	maverik gas card 
granite backsplash	backsplash ideas 
anlytics	marketing analytics 
copper backsplash	copper fit back 
bar table set	buy bar table 
psoriasis	psoriasis disease 
ifetch	chuckit dog toy 
lexus part	lexus parts online 
things to do in colorado springs	accommodation in colorado springs 
tncc	tncc online 
vinyl wood look flooring	vinyl wood flooring 
rural development	rural development program 
lodge in glacier national park	glacier national park tours 
sty	eye sty treatment 
agenda	agenda definition 
santa cruz beach hotel	santa cruz beach boardwalk hotels 
juegos de friv	ben10 toy 
anaytics	marketing analytics 
revocable trust	living revocable trust 
ohio amish country	amish country tour 
sog	sog flash knife 
dkny jeans	dkny jeans sale 
bigcharts.marketwatch.com	stock charts online 
analyticsd	marketing analytics 
pantip	pantip suites bangkok 
14 inch chromebook	chromebook 14 
st charles hotel new orleans	hotel charles new orleans 
msu	msu online 
pet friendly hotel maine	pet friendly hotels 
industrial blender	blender waring 
amelia island plantation resort	omni amelia island 
5 bedroom house for rent	rent to own 
analyticas	marketing analytics 
lpl	lpl find an advisor 
juniper	landscaping with junipers 
sammy	women summer dresses 
dog care information	dog eye care 
denim sofa slip cover	large sofa slipcover 
kitchen microwave cart	microwave kitchen islands 
twin loft bed with desk	twin bed 
violin lesson for beginner	beginners violin 
home and garden decor	decor garden 
love seat sleeper	serta perfect sleeper 
dress up	summer dresses 
mammogram	mammogram guidelines 
detox for weight loss	garcinia cambogia 
argentina	argentina tourism 
luxury hotel in arizona	arizona hotels 
large rectangular planter	large white planter 
water park resort	key lime cove waterpark resort 
lake tahoe california	what to do lake tahoe 
veteryl	1800 pet supplies 
bakers rack	pier 1 
hotel near university of colorado boulder	boulder colorado hotels 
diamond engagement ring wholesale	engagement rings wholesale 
bed to go	beds for girls 
tmj	tmj joint pain 
analytcs	marketing analytics 
things to do in victoria canada	victoria things to do 
devon	devon tourism 
hotel near grand teton national park	grand teton national park hotels 
analtytics	marketing analytics 
lodging in door county wi	door county lodging 
san ramon	san ramon car rental 
helmetlok	helmetlok helmet lock 
toyota prius hybrid price	prius price 
blackhead	treat blackheads 
industrial	industrial earings 
best all inclusive family resort	family friendly all inclusive resorts 
wedding photography tip	photography wedding 
small cast iron wood stove	cast iron wood stove steamer 
eye dropper	www.walgreens com 
best buy	walmart job application 
vacation package san antonio	san antonio packages 
how does fafsa work	financial aid application 
bexar county appraisal district	property search address 
google	goole adword 
cdiff	c diff colitis symptoms 
direct tv nfl package cost	direct tv package 
analyitics	marketing analytics 
garnet	garnet jewelry 
national association of securities dealer automated quotation system stock	stock quotes nasdaq 
brooklyn bridge	brooklyn bridge walking tour 
evening bag	black evening bags 
dog behavior	dog behavior guide 
analtics	marketing analytics 
start up business loan	loans for small business startup 
location	google maps street view location 
window ac repair	window unit air conditioner repair 
vpike.com	street view of address 
gap visa	pay gap credit card 
large metal wall art	metal wall art large 
dream palm beach punta cana	dreams palm punta cana 
adult bib	adult cloth bibs 
wine making supply	wine stopper supplies 
analyics	marketing analytics 
in an instant tv show	tv streaming sites 
cheap handbag	cheap hobo handbags 
oil prices bloomberg	stock market crude oil 
m and t bank	m t bank credit card 
purse	burberry shoes women 
umatilla county jail roster	free jail search 
building a house	clayton home floor plans 
m.facebook.com	how to find a friend 
guatemala real estate	vista real guatemala hotel 
blue emu	walgreens shop 
apply financial aid	apply for fafsa 
arvest.com online banking	online bank account 
paradise cove	paradise cove laua 
medical coding and billing salary	billing coding salary 
student loan consolidation interest rate	student loan consolidation companies 
quest diagnostic	patient appointment scheduling 
air conditioning unit	air conditioner cost 
san ramon	san ramon hotel 
a1 supplement	bodybuilders online store 
clothes	short dresses 
tv package	satellite tv packages 
how much will i have at retirement	calculator retirement 
provident credit union	provident credit union mortgage rates 
online gun store	quick access pistol safe 
plus size bridesmaid dress	plussize dresses 
allure vinyl plank flooring	allure vinyl tile flooring 
defender	defender home security 
arlington toyota	toyota arlington 
airking rolex	diamond rolex 
utah resort	sundance mountain resort 
hotel near bristol airport	bristol airport hotels 
one piece	jumpsuits and rompers 
infant swing	baby swing cheap 
sas shoes	lucky brand shoes 
isle of palm hotel on beach	hotels isle of palms 
15ft christmas tree	christmas tree 9ft 
alaska court view	courthouse records 
turkey tour	turkey tour itinerary 
accelerated nursing program	practical nursing programs 
nscc	nscc online 
rubber pavers	rubber tiles 
crest 3d white strip coupon	online walgreens printable coupon 
grossmont college	grossmont college el cajon application 
fourth of july furniture sales	macys super weekend sales 
anayltics	marketing analytics 
full figure dress	a line dresses 
cerner	cerner hospital software 
roaches	indoor roaches 
best boutique hotel in nyc	nyc boutique hotels 
dysgraphia	dysgraphia definition 
airstream for sale	used airstream campers 
map of utah	mapquest directions 
todayshow.com food	today show recipes today 
sulcata tortoise for sale	tortoise enclosure 
ruger precision rifle	vortex pmr 35 95 
forex canada	forex 
boo loo	boo boo loon 
michaels	michael s art and craft 
luis	san luis obispo flights 
how to use uber	uber town car service 
nissan murano 2013 price	murano price 
vespa	vespa tour italy 
barclay credit card login	barclaycard visa card 
sample size calculator	ac sizing calculator 
apply financial aid	financial aid application 
decorative bird house	dovecote birdhouse 
office 365 pricing	microsoft office 365 home 
italy florence	florence italy attractions 
breakfast casserole	easy breakfast ideas 
hancock	hobby lobby 40 coupon 
pnc mortgage speedpay	pnc mortgage refinance 
perugia	perugia tourism 
melasma	melasma causes 
greentree	green tree home loans 
gun	buy shot gun news subscriptions 
golf hat	coolibar 
corsages	corsage wristlets 
scad university	scad college of art and design 
american girl doll house	american girl baby dolls 
dow jones stock market today	wall street stock market 
analystics	marketing analytics 
bariloche	tourism in bariloche 
craigs	craigslist job post 
kmfusa	kia finance 
free texting	bulk texts 
gold for sale	united states rare coin and bullion reserve 
management information system major	information systems management major 
kid bunk bed	kids white bunk bed 
united arab emirates	united arab emirates tourism 
michael kors backpack	michael michael kors 
discounted lift ticket	discounted plane ticket 
glyphosate	herbicide with glyphosate 
hotel near ithaca college	ithaca college hotels 
friv4	top game design schools 
voltaren gel	gel for pain relief 
best napa wineries to visit	napa winery tour 
platform bed frame king size	best king platforms bed 
otolaryngology	otolaryngology head and neck surgery 
bougainvillea	bougainvillea garden 
battery	auto batteries 
boone nc	house for sale boone nc 
phentermine 37.5	zylene 
ananlytics	marketing analytics 
luxembourg garden paris	hotel luxembourg paris 
built in book shelf	white bookshelves 
light in the box	formal evening dresses 
christmas ornament personalized	ornament personalized 
land for sale	vacant land for sale 
cyber security training online	online cyber security course 
disneyjunior.com	official disney store 
briggs and stratton pressure washer part	briggs and stratton parts 
gucci bamboo perfume	gucci guilty perfume 
you tube	the best of youtube videos 
all free crochet pattern	patterns to crochet 
the lincoln national life insurance company	lincoln life ins 
deductible health insurance	no deductible health insurance 
aramark	aramark application 
emdr	emdr treatment for trauma 
internet speed	att promotions 
adidas climacool shoes	adidas man shoes 
moosehead lake maine	moosehead lake hotel 
krazy coupon lady	groupon 
frame shop	quality picture frame 
patio sofa	patio outdoor furniture 
spreadsheet	microsoft office excel 
penn state football	college penn state 
pink game	pink girl 
free faxing over the internet	free internet faxing 
lexus is c	lexus is250 convertible 
today.com	hsn today special value 
nairobi	nairobi tourism 
fixed income securities	fixed income funds 
prezi	prezi training 
health and wellness	health and wellness textbook 
amtrak san diego	amtrak prices 
external hard drive recovery	external hard drive g drive 
solar garden fountain	wall garden fountains 
obedience training for puppy	potty training puppies 
deal dash.com	group deal specials 
cable internet provider in my area	time warner cable internet 
duck house	duck coops 
sensory toy	sensory toys for toddlers 
alabaster	alabaster florist 
truecouponing.com	couponing com 
sprinkles	buy colored sprinkles 
jack williams	jack williams tires pa 
indianapolis zoo	indianapolis zoo hotel indianapolis 
pell grant estimate	government pell grant 
large wall clock	pier 1 
the young and the restless spoiler	young and restless 
indeed jobs	free job posting 
hap	hap health insurance 
embroidered polo shirt	polo shirts embroidered 
sudan	lonely planet sudan 
painting	paint zoom com 
formentera	hotel formentera 
st croix	all inclusive vacation packages 
sutter creek ca	florist sutter creek ca 
vacation package nashville tennessee	nashville packages 
alabama board of nursing	nursing alabama 
dental implant insurance	get dental insurance 
hair style	modern hairstyles 
idaho car insurance	car insurance idaho 
guatemala	travel guatemala 
cnc	cnc machine course 
hartford airport parking	hartford airport park and fly 
hotel near vanderbilt university	vanderbilt university hotels 
boston celtics	boston celtics youth jersey 
furniture layout	store layout software 
nietzsche	the philosophy of nietzsche 
shirt	funny t shirt 
calculator online	mortgage calculator va loan 
stanley	stanley cleaning products com 
pnc mortgage	pnc home mortgage rates 
loveseat sleeper	serta perfect sleeper 
dicks sporting goods coupon	methylphenidate coupon 
pseg pay bill	online payment services 
auschwitz	visit auschwitz 
savannah hotel bay street	savannah beach hotels 
apps	how are apps made 
is 350	lexus is 350 used 
act registration	act prep course 
scholarship for adult	scholarships for moms 
triangle bikini	junior swimwear 
budget car sales	enterprise car sales 
thrifty airport parking	thrifty car rental airport 
leviton product	leviton switches 
plus size career wear	avenue plus size 
niantic	hotels in niantic ct 
estate planning attorney	personal estate planning 
hood river inn	hotels in hood river or 
mobile te	german used cars 
business liability insurance	liability business insurance 
illinois state university	illinois state university hotels 
who want to be a millionaire	wants millionaire 
tv patrol live	tv streaming sites 
192.168.1.1	linksys wireless router setup 
meningioma	meningioma treatment 
quest diagnostics	quest diagnostics appointment schedule 
menopause	menopause medicine 
beach shorts	black shorts 
oakland county circuit court	court record check 
outdoor patio wicker furniture	wicker outdoor furniture 
mold	household mold 
madison wi lodging	madison lodging 
trinidad express	trinidad trinidad and tobago 
solar lantern for garden	outdoor deck lighting 
tempest car hire	valencia car hire 
darwin australia	darwin australia tourism 
tornado shelter	tornado shelter sign 
cheap hot tub	waterway hot tub pump 
twa flight 800	cheap airline tickets 
hampton bay patio furniture replacement cushion	patio furniture cushions 
delta dental premier	dental dental care 
progressive	insurance progressive 
lenovo yoga	yoga lenovo 
pinterest.com	pinterest decorating ideas 
skindex skin editor	crepey skin 
pay pal scam	my paypal 
alabaster	alabaster vase 
create google account	create a new web site 
electric pole saw	rotorazer saw 
baby keepsake box	keepsake box 
westwood	hotels westwood ca 
leather sleeper sofa	serta perfect sleeper 
restaurant depot hours of operation	thewebstaant 
banana	banana republic employment 
latham hotel philadelphia	hotel latham 
ally auto	allied financial auto 
dryers	sears stackable washer dryers 
hotel near space needle in seattle	space needle hotels 
hot tub pillow	hot tub pump 
red door spa	elisabeth arden red door spa 
maserati review	maserati car reviews 
bing.com	businesss intelligence 
boston whaler	boston whaler accessories 
eco friendly product	eco friendly desk 
sell structured settlement	who buys structured settlements 
company shirt with logo	shirts with company logo 
wall tent	country side wall canvas art 
outlook.com	outlook support 
how does solar energy work	renewable energy solar power 
wordpress	wordpress support 
plus size sportswear	plus size athletic clothes 
degree online university	university online 
lace tops	girls tank 
pool filter cartridge	tiger river filters 
tcf	tcf bank online account 
rv ac	rv ac unit 
history	history channel on line 
itp	itp blood disorder in adults 
cheap shopping	wayfair a zillion possibilities 
catalonia	catalonia tourism 
hair gloss treatment	gloss moderne treatment hair 
sty	treatment for an eye stye 
privacy fence idea	natural privacy fence 
feasible	the merriam webster dictionary 
lacey bra	lace push up bras 
myupmc.com	upmc health insurance 
metropcs.com pay my bill	metropcs cell phones 
dollar to euro	international currency transfer 
apps for google chrome	google chrome support 
learn algebra	online college algebra 
cyprien	hotels in saint cyprien 
cupcakes	jello cupcakes 
menards online store menards store	menards hardwood flooring 
king size	big mens clothing 
vocelli pizza	food delivery 
finance.yahoo.com	msn money stocks quotes 
dual hose portable air conditioner	best portable air conditioner 
verizon wireless internet service	verizon htc one 
elliptical bike	freestride trainer fs7i 
regionsbank.com	online bank account 
camphor	www walgreens 
plus size tunic	plus size clothes 
kitchen tool and gadget	small kitchen gadgets 
preamble	preamble constitution 
bondo	bondo lightweight body filler 
model home	clayton homes 
chicago il	chicago sightseeing 
shell	apply for shell gas credit card 
mississippi river	mississippi river cruise 
zello	real estate appraisals 
dehumidifier for sale	dehumidifier safe 
tarpon springs florida	tarpon springs florist 
hoteles baratos	hotels in el poblado 
fisher price toddler toy	cheap fisher price toys 
blue tooth helmet speaker	bluetooth speakers 
face lift	cost of facelift 
ulla popken	adrianna papell plus size 
gracia	gracia fashion 
cell phone repair	cracked cellphones worth 
tv wall cabinet	cabinet tv stand 
doula	doula birth 
insinkerator evolution excel	insinkerator food service disposers 
long branch nj	condos in long branch nj 
baby stuff	cheap baby stuff 
ottomans for sale	pier 1 
cruise antarctica	antarctica cruise line 
rapid city journal	accommodation in rapid city sd 
how to apply financial aid	financial aid application 
halifax nova scotia	lodging in halifax nova scotia 
hopscotch	hopscotch games for kids 
staples	office supplies 
clicker	garage door clickers 
south korea	south korea tourism 
design your own house	house drawing software 
sleeper chair	serta perfect sleeper 
dental implant insurance	dental insurance quotes 
web master tool	website tool 
open bank account online	open new bank account 
pary	party invitations 
trail runner shoes	trail running shoes waterproof 
calgary canada	things to do banff 
small group tour	small group tours italy 
mosaic candle holder	menu candle holder 
marcone	discount apliance parts 
frysfood.com	coupons for free grocery items 
extreme coupon	coupons inc 
small picture frame	matte picture frame 
israel	hotel israel 
rhino rack	car top luggage rack 
paint	paint zoom com 
yahoo.es	sign in email 
contemporary wallpaper	decorative westelm presents 
clark county municipal court	search court records 
green lawn care	trugreen 
newsday	car rental coupons 
teksystems	teksystems hiring 
cyclamen	cyclamen perennial 
blouse	girls tank 
chapman stick	autographed guitar 
dent repair	vehicle dent repair 
ira deduction	traditional ira deduction 
bar stool table	bar table and stools set 
visor hat	bucket hat 
ebtedge.com balance	ebt food balance 
mississippi	mississippi river cruises 
saipan	saipan vacation 
open enrollment for medicare	enroll in medicare 
clarifying shampoo	nice products walgreens 
prankowl	record phone calls 
niv	1984 niv 
colorado vacation	all inclusive vacations packages 
how much is a kia soul	kia soul car 
perfume deal	perfume cuba 
monteau	amazon prime rewards 
epacket tracking	how to track amazon package 
dumplings	chicken n dumplings 
budapest budapest	hotels budapest city centre 
wood interior door	buy interior doors 
hemp	where to buy hemp seeds 
hk	hk hotels 
hammock strap	hammock and stand 
thompsonspecials.com	cigar sampler 
canary	canary bird cage 
denali	gmc model 
ways to make money online	eterde 
lees summit mo jobs	lees summit mo hotels 
banc of california	banc of california home loans 
floral romper	white romper 
alchemy	alchemy app game 
all inclusive resort hawaii	hawaii resorts all inclusive 
christmas decoration	clearance yards ornament 
austin texas	austin attractions 
brown edu	brown university online 
uticaod.com	utica obituaries 
mcdonalds menu	red lobster food lunch menu 
playground rubber mulch	playground mulch rubber 
salem tv show	tv streaming sites 
sun splash	sunsplash vacation homes 
nsbank.com	online bank account 
logmein123.com	remote access a computer 
cp185	motorola cp185 
how much house can i afford	fha loan calculator 
tricare4u.com	tricare for life claims 
wsecu online banking credit union	online bank account 
best western desert inn	best western safford arizona 
southeasttexas.com classifieds	classifieds free ads 
gmat prep	princeton review gmat 
best protein powder	bodybuilders online store 
regus	regus locations 
flipboard	flipboard app 
florham park nj	florham park nj florist 
trulia	trulia rent 
agora	agora charter school 
superfood	superfood powder 
rainbow vacuum cleaner	proteam vacuum 
mercury insurance payment online	mercury insurance quotes 
thesimsresource.com	the sims 4 download 
plus size disney shirt	plus size shirts 
presto	presto canner pressure cooker 
kid slipper	slippers kids 
uhd tv	uhd tv reviews 
aldi.us	aldi store locations 
golden one credit union	golden 1 checking account 
bridal gown	evening gowns 
house design	2 story modular homes 
vacation house kissimmee florida	florida vacation kissimmee 
flvs student login	florida virtual online school 
hairdresser	careers hairdresser 
folk art	folk poster 
boot slipper	shearling slippers 
cozumel excursion	cozumel vacations 
xxxxl	big man clothing 
plagerism checker	check my paper plagiarism 
fed	fed ex shipping 
nice	hotels nice 
sevis	sevis help desk 
simple ira	simple roth ira 
sylvania ohio	hotel near sylvania 
ceramic toilet paper holder	toilet paper holder roll 
macys insite login	macys 1 day sales 
mopar performance	mopar performance parts 
mitalent.org	www.monster.com 
stock future cnn	cnn stock futures 
premise clothing	theory outlet store 
model trains	hobby lobby coupon 40 
texit	tekkit mod for minecraft 
second grade curriculum	second grade education 
hokkaido	hokkaido japan travel 
debt settlement	settlement debt 
new hampshire attraction	new hampshire vacations 
2014 ford focus	new ford focus 
resort playa del carmen	playa del carmen resorts 
wedding gown	dresses for weddings 
mouse	how to get rid of mice forever 
outdoor garden fountain	outdoor slate fountain 
photo quilt	personalized quilt 
wetransfer.com	website to send large files 
nordstrom	nordstrom dresses 
sargent	military pay rank 
invoice maker	free invoice 
niantic	niantic connecticut hotel 
booter	ddos booter 
honda insight floor mat	2010 honda insight floor mats 
boot	lucky brand hoe 
barona hotel and casino	hotel 
universal protection service	universal protection employment 
mon	monster com jobsearch 
shenandoah	shenandoah spa 
my account	onstar remote link login 
adidas skate shoes	discount adidas shoes 
how much does nursing school cost	colleges with nursing 
career	monster jobs 
venza toyota	new venza 
tennessee vacation	tn vacation 
kitchen curtain idea	kitchen curtain swags 
gray bedding	bedding 
job lot	job lots furniture 
watch32	watch this for free movies 
clovis community college	clovis community college online 
cape canaveral launch schedule	kennedy space center 
jetspizza.com	pizza ordering online 
retirement mutual funds	top retirement funds 
utensil holder	the webstauarnt store 
las	vegas package 
tummy tuck cost	body contouring 
lilo and stitch game	lilo stitch poster 
mortgage calculator with escrow	payment calculator for mortgage 
duke energy bill pay	duke electric ohio 
kut jeans	kut from the kloth jeans sale 
specialized	mountain bikes 
hotel near space needle seattle	space needle hotels 
mykplan.adp.com	my 401k plan 
register	register for a domain name 
panama vacation	panama tourism 
heathrow airport	hire car heathrow airport 
wood cabinet	wood accent cabinet 
siding	siding price 
monokinis	womens swim suit 
record	public record search 
lantern	hautelook home decorations 
large dog breed	large breed dog food 
best whistling tea kettle	tea kettle whistling 
phoenix house	phoenix house rehab 
naperville	naperville flower store 
hgtv	hgtv home cocktailtable 
pgcc	pg community college md 
ashtabula county auditor property search	owner sale property 
bridal store	bridal party dresses 
hotel near capitol reef national park	capitol reef national park hotels 
st vincent de paul	donating used clothing 
canon.com ijsetup	canon pixma drivers 
nc	new homes in nc 
massage spa near me	masage spa 
kroger.com	kroger fuel rewards 
hotel in victoria island	victoria island hotels 
tsys	tsys merchant services 
a7 audi price	audi a7 price 
real time flight tracking	realtime tracking 
sncf	sncf reservation 
mohs procedure	mohs surgery melanoma 
cherokee casino siloam springs	hotel siloam springs ar 
garden fairy statue	garden statue 
california city	florist california city california 
location	google maps 
beach umbrella anchor	beach umbrella sand anchor 
dwyane wade	dwayne wade clothing 
dollar store	family dollar apply online 
grand canyon vacation	vacations to the grand canyon 
poro	hotels in poros greece 
alicante	hotel in alicante 
iad airport	iad airport shuttle 
victory casino cruise	viking cruises rhine 
nice	hotels in nice 
dwarf tree	dwarf trees landscaping 
15 dress	pink dresses 
beast mode	body beast synergistic muscle group workout routines 
puerto vallarta airport	puerto vallarta flight 
cement mixer	globalindustries 
nintendo stock	nintendo stock buy 
papi	papi underwear 
gunn honda	gunn honda used cars 
faulkner county booked	jail records 
neiman marcus last call online	nordstrom dresses 
nxxxx	big and tall clothing 
spc	spc control 
internet service provider	century link north fort myers 
twill pants for man	travel pants mens 
marion county clerk of court	search court records 
ταινιες online	dating online 
2009 prius floor mat	toyota prius floor mats 
wardrobe closet	custom closets 
underwire bra	demi underwire bra 
conneaut lake park	florist conneaut lake pa 
berber carpet sample	carpet berber 
team building	team building ideas 
aptoide	mobile app 
jobs in tampa florida	free job posting 
plus size tunic sweater	plus size sweater 
oak tree for sale	fast growing oak tree 
kodak printer	kodak printers support 
hotel near mccarran airport	mccarran airport hotels 
put in bay island	hotels put bay usa 
exxon mobil	exxon mobil gas credit card 
eye chart	eye doctor chart 
organic	what is an organic food 
npr	listen to npr radio 
tom brady	tom brady memorabilia 
sonic	sonic job 
frontrunner	amtrak routes and schedules 
leather jewelry	leather silver jewelry 
blarney stone	tours of the blarney stone 
hpb	hp coupon 
animal shelter near me	aspca usa 
honda accord 2013 price	2013 honda accord 
walking tour	walking tour of paris 
rustic decor	westelm gifts 
wholesale cologne	name brand perfume 
w hotel san francisco	san francisco w 
delaware state university	delaware state university online 
american funds	american retirement funds 
u pull it	pull a part auto salvage 
sunpower solar panel	monocrystalline solar panels 
prosper	prosper lending 
bra for large woman	extra large bras 
furniture donation pick up	making donation someone memory 
cytokine	human cytokine 
priority pass lounge	credit card priority pass 
earwig	earwig infestation 
davannis	pizza delivery places 
wholesale plus size clothing	plus size ski pants women 
truck camper	camper for trucks 
honeysuckle	honeysuckle bushes 
2005 camry floor mat	toyota floor mats camry 
turan foley chevrolet	banner chevrolet 
home irrigation system	lawn irrigation system 
summer wedding dress	wedding guest dresses for summer 
bright house my services	my bright house 
track my car	onstar gps tracking 
huntington bank login	huntington bank loans 
bethel ny	booking the bethel inn resort 
aptoid	app store android market 
girl accessory	girls hair accessories 
houston tx	aiu houston tx 
tour group	new york tour groups 
cheap loft bed	wood loft beds 
iceland weather	cheap iceland 
rental car in miami	miami rental cars 
inversion therapy	teeter inversion table 
airport hotel los angeles	los angeles airport hotels 
global security	global home security 
montego bay excursion	montego bay hotel riu 
brittany	hotel in brittany 
sat score	sat test scores 
mediterranean	best eastern mediterranean cruise line 
ammonia	pneumonia symptoms 
superfood	superfood dr schulze 
kroger	kroger fuel points 
saia tracking	saia trucking tracking 
best solar landscape light	smart solar landscape light 
talktobo.com	bojangles 
bed	discount bedroom set 
greystone	greystone senior living 
cute sundresses	summer sundresses 
td bank	banking checking account 
kayak	kayak air flights 
maine vacation	all inclusive vacation packages 
nordstrom sale	nordstom 
kitchen microwave cart	microwave kitchen cart 
wedding photography	photography wedding 
bbt.com	bbt online checking 
medigap	what is medigap plan 
internettruckstop	truck freight loads 
bend hotel oregon	hotels bend oregon 
postage calculator	media mail shipping 
express scripts.com	express scripts medicare part d plan 
utube	the best of youtube videos 
wedding favor koozies	custom koozies 
plus size spring dress	plus size summer dress 
snow white costume	halloween costumes 
sam	sams club employment 
metal fire pit	buy fire pit 
junk yard near me	car junk yards near me 
40th anniversary gift idea	anniversary gifts 40th 
sip	voice over ip sip 
backyard	backyard paver designs 
metropolis	hotel metropolis il 
virginia map	mapquest directions 
hp chromebook review	chromebook 14 review 
davis enterprise	enterprise car rental davis wv 
abcya com	game design program 
linksyssmartwifi,com	linksys wifi setup 
bryce canyon national park	bryce canyon attractions 
polk county assessor	property search address 
delta	delta airlines reservations 
meal delivered	family meal delivery 
safety equipment	health safety equipment 
bazookajoe.com	bubble gum 
kaboom	kaboom tile cleaner 
pool filter cartridge replacement	tiger river filters 
organic twin mattress	organic mattress twin 
pantry	furniture 
strategic management process	process management 
sailing shoes	deck shoes 
ipage web mail	ipage web hosting plans 
myapps.paychex.com	payroll online 
general steel building	metal buildings 
kuala lumpur malaysia	kuala lumpur malaysia attractions 
anna	anna linens bedding 
remitly	remitly philippines 
cherokee for less	cherokee workwear 
by	getting ordained 
rowing machine review	quality rowing machine 
chrome dining chair	clearance dining chairs 
esat	satellite radio 
management seminar	national seminars 
car insurance prices	car insurance policy 
sports massage therapist	sports massage dc 
florida vacation home rental	vacation rentals florida 
brinkernation.com	brinkernation payroll 
how does uber work	uber taxi service 
cheap vineyard vine	vineyard vines clothing 
shopgoodwill	goodwill auction site online 
ptcb	pharmacy tech certification training 
chevron crib bedding	crib bedding yellow 
pod 39 hotel	hotel pod 
the last supper painting	last supper wall painting 
zip code lookup	zip code mailing list 
superfood	best superfood powder 
scotiabank.com	online bank account 
quizzle	quizzle credit report 
epdm	epdm material 
strappy bra	free people strappy bra 
bimini	bahamas resorts 
dayforce	dayforce time and attendance 
clay county clerk of court	public records of arrests 
garage door repair seattle	seattle garage door repair 
crib	crib for baby 
geico.co	car insurance 
antelope canyon arizona	antelope canyon tours 
paul mitchell school	hairschool 
what to do in cape cod	cape cod family hotels 
weatherforyou.com	weather today 
xxxl	xxxl mens clothing 
pei	hotel prince edward island 
speed queen washing machine	sears washer and dryer 
berlin md	berlin things to do 
coast hotel chilliwack	coast chilliwack hotel 
cold shoulder shirt	cold shoulder dress 
tsx today	stock market today tsx 
emgo	emgo fuel filter 
hotel new castle	newcastle hotels 
man red pants	mens lined pants 
icloud account	login icloud email 
panaca	panaca hotel 
aptdeco	furniture stores 
exchange rate	forex currency broker 
discount western bedding	western cowboy bedding 
sziget	hotels near sziget festival 
seattle wa	4 seasons seattle 
radio	xm radios 
compact sleeping bag	camp sleeping bags 
safeboxes	safe fire box 
landscape solar light	outdoor solar landscape lighting 
udaipur	hotels udaipur india 
2008 prius floor mat	toyota prius floor mats 
tea length skirt	tea length dress 
s5	s5 galaxy 
government jobs in houston texas area	houston hr jobs 
natural ant killer	non toxic ant control 
english lavender	provence lavender 
self adhesive wallpaper	self adhesive wallpapers murals 
french dictionary	visual dictionary french 
fcbankingonline.com	online banking 
ireland	tourism of ireland 
thrush	medical condition thrush 
silk pantie	bridal panties 
patio paver design	paver patio 
fdle	criminal records 
activity in new orleans	new orleans activities 
old forge camping resort	old forge hotel 
consolidate debt loan	personal loans for debt consolidation 
buy shoes online	wayfair a zillion possibilities 
knee high flat boot	knee high rain boots 
entergy	entergy bill 
flirchi.com	online dating sites for singles 
kirklands	kirklands decor 
gsu	georgia state university mba 
earn to die 2	game network 
2007 toyota highlander floor mat	highlander floor mats 
palm beach property appraiser	commercial property records 
fairfield county municipal court	free court record 
omnibus de mexico	greyhound bus 
metal roofing material	metal roofing material prices 
cachexia	pulmonary cachexia 
shop rite.com	shoprite online 
pelican grand	pelican grand beach resort fort lauderdale 
touch screen computer	desktop touch screen computer 
low cost	low fair flight 
fred meyer weekly ad	fred meyer furniture 
oil change chicago	chicago oil change 
bridgebase.com	match.com 
my fitness pal	walmart job application 
glutathione benefit	glutathione antioxidant 
crazy sock	cozy socks 
lexus floor mat es350	lexus es350 floor mats 
jamaica observer	jamaica hotels 
rainierland	movies online for free 
priority toyota	swope toyota 
small business insurance liability	liability business insurance 
wyndham seawatch plantation	seawatch plantation myrtle 
carelink	carelink health care 
shoes for plantar fasciitis	walkfit shoe inserts 
tapco	tapco pro 
decorative throw pillow	floral decorative pillow 
sprinkler	sprinkler nelson 
ncl cruises 2016	ncl breakaway cruises 
wide fitting shoes	wide shoes 
new england patriot	new england patriots shoes 
the standard	standard new york hotel 
chicas calientes	excellence playa mujeres hotel 
fedbizopps	federal bid opportunities 
stent	what is heart stent 
name art	last name wall art 
inline skate	inline skate bearing 
biochemistry	biochemistry free online course 
monokini	designer monokini 
bangalore	bangalore tourism 
umatilla county jail roster	inmate search 
grants for college woman	government grants for women 
solar calculator	home solar calculator 
discount t shirt	t shirts sale 
outdoor solar fountain	outdoor fountains 
camper shells	new camper shells 
alphabet	learn alphabet 
best western plus the tuscan	best western san francisco ca 
roos	ross home decor 
copart.com	copart car sales 
alvin	hotels alvin 
ghana news	ghana tourist attractions 
boot camp	youth boot camps 
medieval clothing	armachillo 
off broadway show	broadway ticket 
invisible fence collar	petsmart invisible fence 
upc lookup	find upc barcode 
sel service.lausd.net	employee payroll services 
cape cod golf	the villages at ocean edge resort golf club 
the wilds ohio	the wilds hotels 
hhgregg	www homedepot 
rbconline	online bank account 
staples	staples home office 
cuna	cuna life insurance 
mythdr.com	employee schedules 
pvc pipe	pvc plastic tubing 
tannersville pa	hotel near tannersville 
halfbike	`amazon 
ivviva	athletica 
lovies	angel dear 
2012 toyota sienna floor mat	toyota sienna mats 
crkt knife	crkt tool 
hamburger press	new restaurant equipment 
sty	cures for eye styes 
hinds community college	hinds community college online 
chamberlain driveway alarm	driveway alarms 
michelin tire	find michelin tires 
beach wedding attire	wedding guest dress 
arcadia	gmc acadia 
home	bank owned homes for sale 
atlanta public schools	schools in atlanta 
roulette game free	free roulette game 
asus ultrabook	asus ultrabook laptop 
how to become a game designer	video game design 
garbage can enclosure	suncast shed 
primitive furniture	vermontcuntrystor.com 
dixie stampede	branson dixie stampede 
medical administrative assistant certification	medical assisting certification 
air conditioning cleaning service	service air conditioning 
preferred stock	cologne preferred stock 
blue bayou	blue bayou water park discounts 
nucca	nucca chiropractic 
workforce	workforce mgmt 
ibiza spain	hotels ibiza spain 
personalized wine	personalized wine glasses 
web browsers	free website hosting 
armstrong vinyl flooring	armstrong vinyl sheet flooring 
marquette	hotels near marquette university 
prefab cabin	smoky mountain cabins 
hawaii	vacation packages 
flat roofing	flat metal roof 
glass teapot	glass tea warmer 
create web	creating a website 
american first credit union	online bank account 
loyola	loyola university new orleans online 
medical terms	course medical terminology 
underwire bra	unlined underwire bra 
fiu blackboard	florida international university online 
luna	luna carpet 
marcus theater	marcus theater milwaukee wi 
ecampus login university of phoenix	phoenix university online 
abcya	game design schools 
scworks	monster jobs 
dayforcehcm	adp payroll service 
oceanic time warner cable	time warner internet plans 
webuyuglyhouses.com	cash for home 
acute	acute care definition 
chesapeake bay	hotels in chesapeake beach u.s.a 
phone wallet	zip wallet 
thorntons gas station	thorntons gas card 
pool supply online	pool safety supplies 
harborside	harborside inn hotel boston 
ashland university	ashland university mba 
watch the voice	tv streaming sites 
non slip shoes	webstaruant 
contemporary bedroom set	classic bedroom sets 
boise airport	boise cheap flights 
nintendo wii	download games for 3ds 
ascp certification	ascp review 
allyauto.com	ally auto loans 
toyota tacoma cargo net	toyota tacoma cargo 
apex learning	apex tech 
fresno city college	city college fresno ca 
2007 fj cruiser floor mat	toyota fj cruiser floor mats 
hvac company	alpine hvac 
retirement savings calculator	calculator retirement 
all inclusive resort in hawaii	hawaii resorts all inclusive 
sliding patio door	sliding patio door sale 
flalottery.com	florida lottery florida lottery 
supply chain	what is supply chain 
driveit	dryvit installation 
ratchet tie down	rope ratchet tie down 
jobs in dothan al	job posting 
military ball cap	military boonie hats 
metal awning	awning installation 
noir	noir furniture 
cbvacations.com	ocean city md vacation rental 
scrum	scrum training 
websterbankonline.com	personal checking accounts 
numerology	how to read numerology 
english tutor	private english tutor 
airstone	purpleheart shoe moulding 
kwik fill	kwik fill credit card 
plaster of paris	mold making plaster 
live cricket	live stream cricket 
morgellons	morgellons skin disease 
hallesemia	what is thalassemia disease 
boot store	cowboy boot 
azores	travel to the azores 
mansion on turtle creek dallas	dallas mansion turtle creek 
pelican flashlight	pelican 7060 led flashlight 
red rock canyon state park	red rock canyon nevada 
oregon	oregon coast vacations 
2014 hyundai elantra	hyundai elantra sport 
bravofly	low cost flights 
goog stock	goog stock price today 
christmas bedding	regent garden comforter set 
azdrama	hong kong online 
award plaque	corporate awards and plaques 
motorcycle camper	motorcycle tent camper 
graduation cookie	cookie gift 
jack black	jack black sale 
lexus accessory floor mat	lexus es350 floor mats 
santander online banking my account	online bank account 
netflix app for pc	netflix pc app 
ringling brother circus coupon	ringling coupons 
comcast	at t customer service 
how much is a ford focus	new ford focus 
car alarm	alarm for car 
17 inch laptop	17 inch laptop sale 
gateway lending	gateway lending payment 
swim shorts	womens swimming shorts 
syria news	latest news on syria 
fitness machine	fitness bikes 
snagajob.com hourly jobs	www.monster.com 
ceramic bakeware	bakeware set 
lady handbag	ladies bags 
summer school	summer school online 
bear lake utah	bear lake hotels 
pocket t shirt	carhartt pocket t shirt 
civil	civil engineer work 
active wear	crossfit tshirts 
butlins	hotels in bognor regis 
meloxicam 15 mg tablet information	meloxicam drug 
north carolina map	mapquest directions 
north dakota map	map 
extra large dog house	dog door extra large 
gold ira	roth ira gold 
healthgrades.com physician	research your doctor 
hampton court	hampton court palace co uk images 
beaver lake arkansas	beaver village lodge 
aldi	aldi application 
badboymowers.com	john deere riding mowers 
dsfcu	dsfcu credit card 
hyundai sonata floor mat	floor mats hyundai sonata 
suit	black suits 
dryer vent	duct cleaning services 
blush bridesmaid dress	bridesmaids dresses under 100 
fred meyer weekly ad	fred meyer specials 
lexmark printer	lexmark install printer 
engraving services near me	engraving plaque 
reiki therapy	energy healing reiki 
indoor water parks	neptune park inn hotel 
ca dept of insurance	ca insurance department 
nyra belmont park	belmont race track 
credit union cd rate	credit union ira rates 
boxed christmas card	christmas cards boxed 
agoraphobia	agoraphobia help 
doctor online	doctor help online 
readworks	reading skills worksheets 
best high speed internet	high speed broadband internet providers 
bancorpsouthonline.com	online banking 
butterfly costume	halloween costumes 
bwi airport	flight 
jobs in north carolina	warehouse jobs 
chemistry	free chemistry help online 
plush blanket	microfiber blanket 
germany tour package	tours of germany 
celebration station	celebration suites at old town 
davannis pizza	late night pizza delivery 
hybrid rav4	rav4 hybrid 
cooler math game	learning math games 
monroe community college	monroe community college online 
auction auto sales	usa auto auction 
psychologist	university psychologist 
floor plan	clayton home floor plans 
coccyx cushion	tempupedic 
pergola design	pergola home 
argentina	argentinian tours 
jetro	thewebstaurantstore com 
rainierland.com	watch full length movies 
bathroom vessel sink	vessel bathroom sink 
el paso traffic	local traffic report 
bullet proof glass	bulletproof window film 
furniture auction	jewelry auctions 
floor mat for lexus es350	lexus es350 floor mats 
elegant bar stool	regal bar stool 
comcast free norton security suite	comcast norton internet security 
napkin folding	how to fold paper napkins 
fed	fed ex express 
driveway paint	coating concrete driveway 
globalcashcard	global prepaid card 
strasburg railroad pennsylvania	strasburg rail road hotels strasburg 
toyota of colchester	hartford toyota 
tourism	tourism offices 
ielts	ielts course online 
dana buchman clothing	macy one day sale 
weisner in huntsville texas	local gmc dealer 
online career school	school online 
rapsody	rhapsody music player 
etouffee	cajun etouffee 
zumba shoes	jambu sandals 
best annuity rate	retirement annuities 
lupine dog collar	dog collar designer 
part time jobs near me	free job posting 
gosun	sun ovens 
harley davidson solo seat	harley motorcycle seat 
alignment machine for sale	best alignment machine 
canoe cart	kayak canoe cart 
amour	under armour kids 
hip pain	bursitis hip pain relief 
air compressor oil	air conditioning oil 
snapchat login	applications for business 
plus size wedding gown	plus size evening gowns 
memory training	improve memory 
fannie mae homepath	fannie mae repos 
va administration phone number	va loan information 
convertible mercedes benz	mercedes benz convertible 
bonanza.com	bonanza memorabilia 
pay off debt	pay off credit debt 
loctite	loctite corp 
unique halloween costume for woman	unique womens halloween costume 
dbe	dbe certification 
capilano suspension bridge	capilano suspension bridge treetops adventure 
ux	brother dr 350 drum unit 
acupuncturist	acupuncturist school 
peppermill	peppermill resort casino 
craigslist garage sales	local garage sales 
aluminum can recycling prices	recycling cans 
pedicure chair	la spa parts 
dayton air force museum	dayton air museum 
toyo tire for sale	toyo performance tires 
eeee	dunham oxford 
lg420g	lg420g cell phone 
sothwest	southwest airlines fares 
plus size apparel	plus sized clothing 
pink curtain	cottage curtains 
cheap internet access	cheap high speed internet service 
dxtory	dxtory recording software 
four wheelers for sale	atv john deere 
monterey park ca	flower shop monterey park ca 
rolling kitchen cart	kitchen cart wheels 
medicare age	what age is medicare 
baby diaper	newborn baby diapers 
3pl	3pl warehouse 
prothane	prothane engine mounts 
sweden	sweden tourism 
spokane airport	spokane airport rental cars 
san juan pr	what to do in san juan puerto rico 
electrostatic furnace filter	carbon furnace filter 
vinegar and baking soda	vinegar baking soda drain cleaner 
xfinity on demand	on demand movies 
bronchitis	severe bronchitis symptoms 
bcaa supplement	bodybuilders online store 
2011 corolla floor mat	toyota corolla floor mats 
highland park il	florist in highland park il 
ewtn live	tv streaming sites 
memrise	learn english online 
comdata	comdata checks 
toll calculator	highway tolls calculator 
tour in punta cana	punta cana tours 
texas farm bureau pay online	texas bureau insurance 
fau	fau online degree 
watermelon	watermelon slice 
queen anne furniture	furniture stores 
basil	italian basil plant 
pepsico	pepsi job application 
hidalgo county tax office	property taxes assessment 
flipcart	florsheim shoes 
hotel near arundel mills mall	arundel mills hotels 
omelette	omelette recipes 
flower garden	flower garden hotel roma 
car rental rochester ny	car rental greater rochester international airport 
little boy blue	little boy blue motel california 
redfin	free listings of foreclosed homes 
rock revival jeans	macy one day sale 
environmental management	environmental management university 
what temperature is chicken done	chicken safe temperature 
chipp	chip health insurance 
net10.com	net10 prepaid plans 
idyllwild arts academy	idyllwild california tourism 
blood clot in leg	deep vein thrombosis signs 
japan crate	japanese crate engines 
hotmail.com	e mail lists 
nizoral	www walgreens 
strong supplement shop	bodybuilders online store 
oxycodone	oxycodone treatment 
nb	barnes noble books 
blackwater	blackwater florist 
things to do in philadelphia	hotels downtown philadelphia 
a10	a10 envelopes 
apple bottom jeans	apple bottoms tops 
sequin bridesmaid dress	sequin party dress 
american modern insurance	modern home insurance 
bird carrier	large bird cage 
arctic cove mister	patio mister 
kazakhstan	travel to kazakhstan 
airasia	cheap airline tickets 
floor mat auto	car floor mat sets 
picture of aruba	activities in aruba 
honda of burleson	honda clearances 
bluffton sc	mls bluffton sc 
rent the runway	revovle 
spartacus	spartacus starz 
msnbc live streaming	tv streaming sites 
bugout bag	blackhawk s.o.f carrying bag 
comcast business internet	comcast business broadband 
home delivered meal	family meal delivery 
wide leg jeans	nydj sale 
westmont mercedes	mercedes benz westmont 
icollege	georgia perimeter college online 
webmail.earthlink.net	inexpensive internet service 
qwest	centurylink phone service 
quince	quince bush 
santanderbank.com	online bank account 
movie database	movie internet database 
cheap handbag	cheap leather handbags 
axial fan	dayton axial fan 
top fat burner	zylene 
orlando florida attraction	dinsey world 
livelinks.com	dating service 
hallmark channel	hallmark movies online 
toyota oem floor mat	toyota floor mats camry 
robin jeans	nydj sale 
tucson jobs	tucson monster jobs 
apple bottom jeans	apple bottoms shirts 
recycle bank	recycling rewards program 
top online certificate program	certificate programs online 
aptoide download	mobile app development 
stir fry	healthy stir fry recipes 
hotel in belltown seattle	belltown seattle hotels 
craig	craigslist jobs 
peru machu pichu	day trips to machu picchu 
schneider	cdl trucking 
plus size short shorts	plus size lee shorts 
fivestarscard.com	loyalty program rewards 
gate1travel	groupons 
aluminum cleaner	zep professional 
utube	youtube music video promotion 
scottsdale	scottsdale hotel 
google gmail	gmail 
hotel near broncos stadium	denver broncos stadium hotels 
affiliate	affiliate marketing 
orange county superior court	search court records 
kltv.com	live weather radar 
belkin	support belkin 
scotland	scotland tourism 
things to do in alaska	cruise to alaska 
taxslayer	taxslayer tax software 
how to option trade	how to trade option 
g2a.com	games on gsn 
twin sleeper chair	serta perfect sleeper 
sensory toy for autistic child	sensory toys for toddlers 
us population	1910 census records 
backyard creation patio furniture	deep seating patio furniture 
fc bayern munich	bayern munich jersey 
skull ring	buy skull ring 
doha qatar	my flight to doha 
make your own laundry detergent	allertech laundry detergent 
perm	acid perm 
alcatraz prison	ferry to alcatraz 
hotel suite downtown chicago	hotel downtown chicago 
best resort in riviera maya	riviera maya resorts 
asus.com	asus support 
faroe island	faroe islands flight 
half bike	`amazon 
delta sigma theta	delta sigma theta jewelry 
liposuction	what is the cost of liposuction 
nantes	nantes hotels 
spa for sale	spa covers for sale 
lilac tree	japanese lilac trees 
lakeland	university lakeland 
ontario map	directions mapquest 
umami	umami paste 
holiday decoration	unusual christmas decorations 
booths	webstaurant equipment 
yosemite national park map	mapquest directions 
prince	princess cruises in 
old faithful inn	yellowstone lodge yellowstone national park 
windsor	cotton dresses 
lederhosen	oktoberfest lederhosen 
home for rent in panama city beach fl	hotel panama city beach fl 
designer eye glasses for man	designer reading glasses for men 
patio planter	planters 
macintosh	macintosh computers 
online mba health care administration	mba healthcare administration online 
miss chic jeans	missme jeans 
legalporno	free online movies 
pohanka hyundai	local hyundai dealers 
aquaphor	walgreens online coupon code 
massillon independent	the independent 
craigslist st augustine	new homes for sale in st augustine fl 
tablet repair	tablet screen repair 
blush brush	smashbox blush brush 
backpack for man	backpacks for boys 
accenture	job accenture 
hotel near university of virginia	university virginia hotels 
deep creek md	wisp nlp 
denver airport map	denver international airport hotel 
sam levitz	furniture on line 
toshiba	toshiba help 
eyeglass repair	eyeglass companies 
hotel las vegas convention center	vegas convention center hotels 
ball gown	formal gown 
cleveland browns	cleveland browns tickets 
inexpensive furniture	sure fit slipcover outlet 
optonline email	email login 
care credit pay bill online	credit card no annual fee 
ufix.att.com	atnt uverse 
adptotalsource.com	employee payroll services 
fashion web site	fashion dresses 
silvergames.com	buy silver bars 
apple warranty check	apple warranty number 
engineered quartz countertops	how much do quartz countertops cost 
zometa	infusion for osteoporosis 
dayminder	dayminder refill 
4 wheelers	atv john deere 
remax realty	edina realty 
car key replacement	replacement keys 
walgreens	weekly sales 
retiree.aon.com att	aon retiree health exchange 
silver curtain	floral curtains 
retirement income planner	calculator retirement 
sheridan	hotels in sheridan wyoming 
flea	flea pest control 
nurse movie	how can i watch movies online 
cheap gps tracking device	home gps tracking devices 
anywho	reverse cell phone look up 
avista	avista resort hotel 
disney halloween costume	disney costumes for kids 
jamaica observer	jamaica where to stay 
santas	santa town 
backpack blower	worx leaf blower 
dixieline	dixieline patio furniture 
defender marine	canvas boat shoes west maine 
psiphon	download psiphon for pc 
loungefly	disneyshop 
orchard supply	gardeners supply 
nxnn	big sexy hair spray 
air park	airpark airport parking jfk 
lds indexing	lds indexing program 
waptrick	gsn game free 
prensa libre guatemala	guatemala cheap flights 
peacock bedding	peacock alley sham 
rmf fm	fm radio antenna 
veuve clicquot	cliquot champagne 
ilford	ilford papers 
yandex.ru	rugs 
makeover	virtual makeover hairstyles 
gannon university	gannon university online 
microsoft edge browser	microsoft software update 
glock 19 price	`amazon 
odd future	odd future shoes 
shimano	shimano spinning reel 
y8	www.free slot game.com 
disney news	disneys boardwalk villa 
duck tour	ride the ducks coupon 
sears sales ad for this week	macys one day sale 
couple cooking class	teen cooking classes 
house for rent near me	rent to own homes 
price of wheat per bushel	kansas wheat prices 
gps fleet management system	gps fleet tracking 
tool	zorrotools 
logmein123.com	remote access support 
innova	innova car scanner 
abstract art	large framed artwork cheap 
straight talk refill	straight talk verizon 
medical class online	medical assistant classes online 
arthritis diagnosis	arthritis arthritis 
missouri state university	missouri state university online 
n12.ultipro.com	employee payroll services 
kid storage furniture	kids furnitures 
toyota leasing offer	toyota leasing deals 
costco visa card	costco accept credit card 
koora live	tv streaming sites 
spain	tour spain 
grade b maple syrup	maple b syrup 
hungary	hungary travel packages 
zagat	2015 zagat 
labcorp	schedule appointments 
national life insurance	national life ins 
toyota oil filter wrench	oil filter wrenches 
golds gym 450 treadmill	golds gym crosswalk 570 treadmill 
adidas skate shoes	black adidas shoes 
qs	freescore.com 
alachua county jail	county jail inmate search 
53 bank	53 bank checking account 
wrx	2015 subaru wrx impreza 
lexus cargo mat rx350	lexus rx350 cargo mat 
castle	abc tv castle 
medication identification	medical identification 
pima community college	pima community college online 
lots for sale	free foreclosed homes sale 
hobbit house	hobbit hut 
plus size strapless shapewear	shapewear plus 
hotel in newcastle	newcastle hotels 
peace lily	peace lily plants 
indeed jobs orlando florida	accommodation orlando florida 
ada county jail	county jail search 
cost of medicare	aarp health insurance plans 
yc	yavapai college 
ses	www.angieslist.com 
toyota camry 2012 floor mat	toyota floor mats camry 
oldcastlecareers.com	old castle pavers 
mini backpack	columbia duffel bag 
vinyl soffit installation	installing vinyl siding soffit 
florida family resort	family resorts in florida 
small front yard landscaping idea	front yard landscaping design 
bezel set diamond necklace	bezel set diamond solitaires 
prescription safety goggles	safety glasses and goggles 
baileys	baileys chainsaw 
rci.com	rci points resorts 
hardware	drawer hardware 
bamboo roll up blinds	bamboo blinds 
splash house	splash guest house 
things to do in north myrtle beach	myrtle beach things to do 
bonaire	bonaire caribbean 
are life insurance proceeds taxable	life insurance taxable 
gold ira	what is a gold ira 
leather bag	fossil leather bags 
baby aspen	aspen baby clothes 
ebay ca	easbay 
gain coupon	printable grocery coupons 
beer mug	promotional beer mugs 
stock market	trade in the stock market 
healthgrades.com	research your doctor 
bruxish	bruxism symptoms 
geocaching	geocaching garmin 
rick steves europe	rick steves europe tours 
stairs	all stair treads 
beneficial	beneficial personal loan 
google tra	professional translation 
ear thermometer	braun digital thermometer 
marquette	marquette university hotels 
discount vinyl flooring	vinyl floor 
where to invest	invest now 
plaid dog collar	embroidered dog collar 
sams	sams club employment 
international travel insurance	travel guard trip insurance 
ultrasound technician	ultrasound technician training 
pga	pga tour leaderboard 
lasix water pill	furosemide heart failure 
ranitidine	ranitidine tablets 
mo	www.monster.com 
boat cleaning product	3m boat cleaner 
brother laser printer	brother printer com 
plus size	plus sized clothing 
pal	philippines airlines 
oldsmobile	buick awards 
hubporn	free online movies no download 
pony	travel pony deals 
custom dress shirt	embroidered dress shirts 
american hotel	america village hotel 
cobb county tax assessor	property tax assesment 
arris	arris cable modem setup 
gas chain saw	concrete chainsaw 
food4less	food 4 less job 
wedding book	wedding shower guest book 
gluten free basket	gluten free nuts 
hibbits sporting store	hibbits sports shoes 
fantasy fest key west	key west florida tourism 
motorcycle dog carrier	bag dog carrier 
oriley	automobile stores near me 
prolactin	high prolactin symptoms 
fha calculator	mortgage calculator fha 
suite in san diego	embassy suites downtown san diego 
best fat burning supplement	bodybuilders 
larson	lawson part 
oil etf	oil etf symbol 
restaurant point of sale	restaurant point of sales systems 
trazodone	trazodone pain 
freerice	rice bowl 
firv	new super mario bros 
family relationship chart	relationship chart genealogies 
npi	physician npi database 
shopper food warehouse	shoppers food warehouse coupons 
toyota el cajon	toyota deals 
outdoor kennel for dog	dog kennel outdoor 
christian shirt	christian stores 
direct tv sports package	direct tv package 
chiavari chair wholesale	chiavari chair covers 
cowboom deal of the day	coupons for overstock 
gardall safe	wall safe 
logmein123,com	remote desktop support 
metal home	metal home designs 
rbfcu net branch online logon	online bank account 
plus size high waisted jeans	plus size flare jeans 
heritage hills	heritage hills golf york 
افلام six	six flags over georgia hotels 
old town hotel	old town plaza hotels 
oven heating element	whirlpool oven heating element 
toyota rav4 review	toyota rav4 reviews 
haccp	haccp plan example 
mlslistings.com	mls home listings 
buca di beppo	buca di beppo dinner menu 
hannaford supermarket	hannaford jobs 
full figured dress	a line dresses 
red nose day	red nose day shirts 
cheap chacos	o stock 
ada grab bar	grab bars ada 
internal auditor job description	internal auditor job description sample 
wescom	wescom mortgage rates 
menards	menards hiring 
hnslicense.net	cosmetology license kentucky 
furnace filter 16x20x1	16x20x1 filter 
modern entertainment center	entertainment center shipping to ontario 
crescent	crescent street hotels 
ndsu	north dakota state university enrollment 
illinois property tax	property tax assessment 
channel 5	tv streaming sites 
nj map	directions mapquest 
blepharoplasty	blepharoplasty eyelid 
kt tape	walgreens ad 
cannon safe for sale	cheap safe 
how much does travel insurance cost	travel insurance prices 
map of delaware	maps directions 
kohls customer service number	girls tank 
bay area nissan dealer	nissan dealerships 
free christian sheet music	free sheet music 
pono kai resort	pono kai condos 
oil change in santa barbara	santa barbara oil change 
casual corner	talbots.com petites 
pick up truck	new pick up truck 
japanese maple tree for sale	japanese maple tree care 
act test preparation	princeton review act 
clevage	big breast cleavage 
nccourt.org	public court records search 
los angeles to san francisco	los angeles san francisco tours 
door	pet doors 
shabby chic chair	shabby chic decor 
capodimonte	hotel capodimonte 
calendar template	save the date calendar template 
golf equipment	global golf discount 
price match	hotel discount 
hotel surfside beach	surfside beach hotels 
class c rv	used class c motor home 
bob howard	bob howard buick 
esmeralda	esmeralda resort orient bay 
windstreamemail	email login 
yacon	yacon root 
hunter sprinkler head adjustment	sprinkler adjustment 
roaches	roach eradication 
waterway pool pump	waterway spa pump 
sc	south carolina travel 
deck screw	screws for decking 
green stool	green bowel movement cancer 
cooks.com	diabetic recipe 
assurant	assurant auto insurance 
cnn news live stream	cnn tv channel 
open source	open source application development 
used cummins engine for sale	used cummins diesel engines 
woodpecker	woodpecker pest control 
hotel in henderson nevada	henderson nevada hotels 
traverse city beach hotel	sugar beach resort hotel traverse city 
trailer dollies	mover dolly 
chipmunk trap	do my own pest control 
plus size skater dress	plus size wrap dress 
zillow	http www house values 
beef wellington	easy beef wellington 
bedside cabinet	bed side table 
sarcoidosis	sarcoidosis diagnosis 
tamarind	sweet tamarind chutney 
2014 ford explorer	new ford explorer suvs 
hayesville nc	hotel hayesville nc 
direct cash lender	cash loans direct lenders 
entertainment wall	entertainment center shipping to ontario 
average college debt	college student debt 
online buying	overstock sale 
2002 toyota highlander floor mat	2013 highlander floor mats 
wedding gown designer	wedding dress gowns 
taxi	local car service 
myhotbook.com	online dating sites for singles 
out	outlook com 
covington ky hotel on the river	hotels covington ky 
affordable car rental	cheap car rental discounts 
ll bean coupon	overstock c0m 
medicare billing code	medical billing coding 
ineedajob.com	monster 
nursery	online nurseries 
cross sound ferry	orient point ny ferry 
used commercial kitchen equipment	kitchen commercial equipment 
basic energy services	basic energy services employment 
lexus floor mat es300	lexus es350 floor mats 
whirlpool duet dryer manual	whirlpool dryer duet 
chicago l train map	amtrak prices 
hot flashes	help for hot flashes 
american express login to access account	express american 
portable oven	portable gas pizza oven 
linksys smart wifi	linksys wifi setup 
westin mission hills resort	westin rancho mirage 
man shirt wholesale	wholesale golf shirts 
rocks	decorative garden rocks 
neck gaiter	sun proof clothing 
liver detox supplement	liver cleansing detox 
pod rental cost	containers rent 
map of israel	israel tour map 
msrp price	nada book value 
safety work vest	work safety vest 
african american art	african american art on canvas 
brazil	travel to brazil 
aluminum boat	aluminum boats fishing 
cheap dental insurance	aarp health insurance plans 
gwinnett place honda	honda dealers 
jandal	jandals 
grilled watermelon	grilled watermelon recipe 
ebay golf	preowned taylormade clubs 
purse	large purses 
boynton beach fl	hotel near boynton beach 
rain bird part	rain bird sprinkler 
harrow	harrows patio furniture 
gonorrhea	what is gonorrhea 
cabin in sedona	sedona hotel 
cheap internet service provider	time warner cable internet 
cruises in january 2015	january cruises 
tenacity	what does tenacity mean 
gradelink	school grades online 
syria map	national geographic maps 
coursera.org	online college courses 
roth ira withdrawal	roth ira requirements 
menards	menards products 
ace hardware	ace cash express loans 
biomedical engineering	intro to biomedical engineering 
alks	aleks math program 
schwans.com	swanson delivery food 
wu	western union send money 
2004 lexus es330 floor mat	lexus es350 floor mats 
nors	nordstrom dresses 
lash lift	eyelash enhancers 
cibc.com	online bank account 
peru	tour peru 
ford recall	recall ford escape 
astrophotography	astrophotography telescopes 
freedom mortgage	american freedom mortgage 
esl.org	esl teacher training 
ultipro.com	employee payroll services 
womens plus size sleepwear	womens plus size sleepshirts 
statement earring	earrings 
rash under breast area	red skin rash 
carter cave state resort park ky	carter caves state park resort 
ingles	ingles sale paper 
hobbycraft	hobby lobby coupon 40 
retirement age	retirement age in usa 
panasonic lcd projector	projectors panasonic 
rainbird.com	sprinklers installation 
tillamook cheese factory	tillamook oregon 
ge profile refrigerator	ge profile series 
time4learning	home schooling curriculum 
portable sauna	portable home steam sauna 
chehalis wa	hotel near chehalis 
scheduleanywhere	online employee scheduling software 
sap erp	sap practice 
mesa verde	mesa verde national park hotels 
clip art	downloadable clip art 
thin wall pvc pipe	pvc flex pipe 
medicare advantage vs medicare supplement	medicare gap insurance rates 
oklahoma city community college	college in oklahoma city 
blue tooth shower speaker	bluetooth speakers 
couchtuner	tv and internet 
wood grain porcelain tile	porcelain wood tiles 
home solar panel	solar panels home 
rainiertamayo.com	watch this free movie online 
foggers	pest control foggers 
flyingtogether.ual.com	unted airlines 
inflatable hot tub	hot tub water pumps 
pet coupon	dole coupons 
rennes	rennes hotel 
online business management degree	online business degrees 
intrepid	intrepid nyc 
tibia	tibia bone fracture 
yoga pose	yoga work out videos 
cross body bag	burberry handbags crossbody 
ruby jewelry	ruby gemstone jewelry 
wood planer review	portable wood planer reviews 
web design school online	online web design school 
winter jacket	winter jacket women 
nationwide retirement solution	nationwide retirement plan 
hard plastic pool	plastic swim pool 
ipad mini repair	trade ipad mini 
metal garage building	garages buildings 
courts.state.va.us	court 
uub	dragonball z vegeta 
allison	online it courses free 
multiplication game for kid	multiplication tables for kids 
nbc schedule	nbc schedule for tonight 
private medical insurance	private healthcare insurance 
chambray shirt	armachillo 
gm vin decoder	decode vin number 
soft leather handbag	discount leather handbags 
lace bra	lace push up bras 
clotrimazole and betamethasone	clotrimazole cream 15gm 
gutter helmet	gutter cleaner 
lake mead	lake mead las vegas 
horizon	horizons math 
ford fusion hybrid for sale	ford fusion hybrid cost 
craigslist modesto	craigslist modesto cars for sale 
prescription drug insurance	medicare part d prescription plans 
preventing diabetes	diabetes type 2 foods to avoid 
large sectional couch	discount sectional couches 
ashtabula county auditor property search	property value zillow 
fubu	fubu shorts 
house for rent in galveston tx	hotel galveston tx 
craigslist	used cars for sale 
truss	residential roof trusses 
murano italy	tour burano murano italy 
contraception	contraception definition 
egesa fm	fm 95 radio 
cheap hotel blackpool	blackpool hotels 
zion canyon national park	motel zion national park 
lake okoboji iowa	hotel okoboji 
top probiotics	probiotic 
pimco	pimco bond funds performance 
biodegradable laundry detergent	rain laundry detergent 
dress for success	donating used clothing 
biologics	biologics rheumatoid arthritis 
perkins loan	pay perkins loan 
mor	mor furniture store 
workplace.schwab.com	schwab retirement plan services company 
how much do you have to make to file tax	how do you file taxes 
cost to install laminate flooring	laminate flooring install 
boot sock	womens boot socks 
new york jets	new york jets football tickets 
clonidine	clonidine adhd 
outlander merchandise	`amazon 
debt ratio	income to debt ratio 
cheap flight fare	cheap flight 
wall mounted desk	furniture 
macy gray	macys one day sales 
amazon dress	ladys dresses 
phoneclaim.com att	cell phone claim 
commercial coffee machine for sale	commercial coffee maker 
myaline	employee payroll services 
landlord credit report	landlord tenant credit report 
keewaydin island	marco island hotels 
lock pick set	lock picking 
jailtracker.com	jail records 
car rental richmond	richmond rental car 
mathman	math games for kids age 8 
floating dock	floating dock hardware 
king size clothing for big and tall	big and tall 
dfw map	directions mapquest 
rival crock pot	replacement.com 
cheap koozies	printed koozies 
computer part	computer assesories 
harlem	hotels harlem ny 
pbskids.org wild kratts	wild kratts suit 
ipo	stock market ipo 
sacred heart	sacred heart hotel 
fa	open facebook 
bargain hunt	coupons for overstock 
hillsborough county jail	county jail inmate lookup 
2005 corolla floor mat	toyota corolla floor mats 
fishing shirt	sun proof clothing 
bpo company	bpo companies in usa 
sports physical	sports physical clinic 
chevrolet miami	chevy dealers miami 
shadow ridge	shadow ridge resort hotel park city 
polystyrene	polystyrene styrofoam 
sendearnings	earn cash for surveys 
orland park il	orland park il florist 
weather channel on direct tv	direct tv channel 
mybalancenow.com	prepaid visa credit cards 
sun room	custom sunrooms 
cabin fever	smoky mountain cabins 
miami resort on the beach	resorts miami 
thomas nelson community college	thomas nelson community college courses 
chief aircraft	chief aircraft avionics 
kill devil hills rental	hotel kill devil hills nc 
anvil	anvil knitwear 
h mart	h mart hotel 
ash wood	ash wood lumber 
door draft stopper	draft door stopper 
used macbook air	refurbished macbook air 11 inch 
pdf escape	editing pdf files 
pyrex	pyrex glass cookware 
frozen merchandise	disney frozen pajamas 
seagate	seagate tech 
count down	countdown digital clock 
adjustable	adjustable bed frames 
mag mile hotel	hotels in magnificent mile 
spiritual	spiritual religions 
electrolux oven part	electrolux part 
magnuson hotel	magnuson hotel clearwater beach florida 
utsa	san antonio university 
things to do in raleigh nc	hotel raleigh nc 
sublimation	sublimation print 
calendar	make a calendar 
lake michigan	places to stay on lake michigan 
palmetto bluff	the inn at palmetto bluff bluffton south carolina 
hotmail	expedia hotels 
united airline reservation	united flight 
marketwatch	tips stock market 
custom shower stalls	new shower stalls 
car wash	car wash service 
sailing shoes	water running shoe 
verizon unlimited data	verizon htc one 
second degree nursing program	practical nursing programs 
crema marfil marble	crema marfil honed marble tile 
best cleanse	best colon cleansing 
adjustable dress form	singer red dress forms 
pandigital	pandigital reader 
tinseltown	tinseltown showtimes 
top running shoes	runnersworld subscribe 
ge dryer knob	maytag washer dryer replacement parts 
marinemax.com	boating supplies and accessories 
peppermill restaurant	peppermill resort spa casino hotel 
sonobello	body contouring 
nordstorm.com	nordstrom dresses 
hofstra university	hofstra university mba 
support.nintendo.com	3ds games 
us bank internet banking	personal checking accounts 
glidden	glidden house 
mazda 6 cost	mazda 6 sales 
boomless sprayer	chemical sprayers 
hardin county detention center	county jail inmate search 
package to costa rica	costa rica travel packages 
mortgage prepayment calculator	payment calculator for mortgage 
denver co	vacation denver 
cool pillow	tempurpedic breeze 
asus zenpad	tablet asus 
shower door installation	shower installation 
mecum	mecum car sales 
navigation	gps maps 
deepwater horizon	deepwater horizon settlement payment 
address	yellow pages oklahoma 
pay comcast bill online	payment system fees 
wholesale fragrance	women fragrances 
bad credit installment loan direct lender	direct installment loans 
decorative pillow for couch	plaid decorative pillow 
fts	send flowers 
sesloc	sesloc san luis obispo 
high collar shirt	collarless dress shirts 
samsung apps	samsung mobile apps 
data entry test	online data entry 
columbia city indiana	florist columbia city indiana 
direct loan	direct loans online 
intervention	what channel is intervention on 
kia prices	kia new model 
aa	aaa insurance 
shopper	survey shopper 
card wallet	clutch wallet 
jobs in alabama	free job posting 
medicare advantage plan	medicare advantages 
resort south padre island	south padre island resorts 
custom shed	lifetime sheds 
craft warehouse	coupon for hobby lobby 
mazda richmond	richmond mazda 
top stock pick	best stock picks today 
mesothelioma attorney	mesothelioma 
meadowlands racetrack	hotels in meadowlands 
junk gypsy	gypsy junkies clothing 
boy waterproof boot	waterproof toddler boots 
emory university	emory university medical school 
kid football	kids football jackets 
day inn fernandina beach fl	days inn amelia island fl 
laundry bins	bathroom furniture hamper 
internal temperature of chicken	chicken safe temperature 
barclaycard us	barclaycard secured credit card 
canon refurbished	slr digital camera refurbished 
small dishwasher	18 inch portable dishwasher 
investment adviser	registered investment advisor representative 
fat burning food	top fat burning foods 
black tops	tunic tees 
free certificate	award certificates 
brent crude price	stock market crude oil 
motocross action	motocross store 
missing money.com	missing unclaimed money 
acrylic	acrylic glass 
gray dresser	gray dresses 
forex training	forex 
united bmw	bmw of monrovia 
esbl	what is esbl infection 
at t repair phone number	at t phone line repair 
ally	ally financial auto loan 
heidi klum	heidi klum womens 
aubrey	aubrey cream 
north texas truck stop	north texas truck sales 
evening gown	alex evenings jacket dresses 
pineapple	pineapple fruit slice 
collin county jail	inmate search 
lolskill	league of legends posters 
boat accessory	boat ladder accessories 
moviestarplanet.com	www.monster.com 
gate way travel	trip to gateway 
ben10	ben 10 party supplies 
zip code lookup	usps 
tmj	tmj dentist 
4 month old baby	baby development 4 months 
baton rouge	hotels baton rouge louisiana 
houston tx	credit repair in houston texas 
massage spa near me	local massage spas 
football party decoration	discount football decorations 
wheelbarrows for sale	aerocaet 
cashcentral.com member login	payday loans 
pokemon the first movie	mewtwo strikes back 
internet truckstop classic 3.0	truckstop load board 
applebees.com	applebees application 
state of nebraska jobs	state jobs nebraska 
zola	zola bridal registry 
wf	15 year fixed rate mortgage 
brainpopjr	game design program 
discount police gear	discount safety gear 
reflex math	math tutors 
meatballs with grape jelly	meatball recipe 
letter of interest for a job	resume writing how 
business strategy	business strategy class 
pergola design	design pergola 
wiziwig	football streaming 
pop corn machine	the webstauarnt store 
new york central mutual	new york mutual insurance 
tcf bank login	tcf bank checking 
real diamond earring	lab diamond earrings 
decorative accent pillow	cottage decorative pillow 
african dress	sundresses for women 
infrared cooking	infrared cooking thermometer 
verizon router	verizon htc one 
how to budget your money	how to start a budget 
ktvu live stream	tv streaming sites 
pirate boot	toddler pirate boots 
ryobi trimmer	www worx gt 
limerick	limerick tourism 
el paso times	el paso birth records 
free photo book	picture book maker 
costa rica vacation package	package trips to costa rica 
fuel management system	fuel monitoring systems 
siding company in kansas city	kansas city siding companies 
rolex daytona stainless steel	daytona rolex 
glider chair	rattan living room furniture 
green stool	symptoms of colon cancer 
husqvarna part	parts for husqvarna 
direct tv weather channel	direct tv channel 
interior paint colors	interior paint colours 
hgtv fixer upper show	hgtv decorating 
christmas tree store	www.hobbylobby.com coupons 
man driving mocs	tods driving mocs 
