steak on sale in burlington ontario	steak on sale
lefwehlwf mwnflnldf wglsndgnwdmgnwdnglwndvnsdm vnmsnv madv mkjsnd mgnwedmfklwmnd fmnsdm dsm smdg msdlgnkldsnglwdmg klwdmk leklmw	m a d v
allen and roth chandeliers antique brass	chandelier antique brass
marine electronics in bellingham wa	marine electronics in
sata storage technology full version	sata storage technology
wall beds victoria bc	walls beds
petsmart aquariums 10 gallon precio	aquariums 10 gallon
alegria size 37 for sale	alegria size 37
bracken creek com	bracken creek
mannequin homme grand montréal acheter et vendre	mannequins
table tennis table &amp rackets city of toronto toronto gta buy and sell sporting goods exercise other	table tennis table
amerikada maglite	maglite
branch red coral	red coral
pooch paw box	pooch paws
vinegar making kit toronto gta	vinegar making kit
amaryllis bulbs wholesale	amaryllis bulbs
spectraflair powder	spectraflair
used zero turn mowers 72 riding mowers	turn mowers
front clip fora 525i 2002	front clip
tapworks distillers	distiller
ed pinaud diffuser	pinaud
athens silver cream field tile	athens silver cream
volume lighting 3 light pot rack	light potrack
southwestern nativity	nativity
reproduction barn door	barns doors
craigslist al50pd	al50pd
lg eg9600 canada	lg eg9600
3 pole 200 amp stab lok	3 pole 200 amp
oral calcium ampoule	oral calcium
kstk1 grand montréal acheter et vendre	kstk1
hobart hcm 61	hobart hcm61
used pet stroller canada	used pet strollers
friskies cat food coupons canada	friskies cat food coupon
chocolate pot lid	pot lids
12 pack painting knife 8 drafting engineering art general catalog	painting knives
soaker tubs with heater for sale	soaking tub with heater
surejoint for sale online	sure joint
part 88 023	88 023
nice mushroom lamps for sale	mushroom lamps for sale
target tv stand 49 inch	targets tv stands
where to buy smart point no mar tips	no mar tips
xenon ballast 35w honda accord 2004 ex 2.4 l honda accord 2004 ex sedan 4 door 2.4 l 2354cc l4 gas dohc naturally aspirated xeno	xenon ballast 35w
dayton 4c634 room to room fan	room to room fans
jurassic world legos gratis	jurassic world legos
power steering pump fe6 ud	power steering pumps
how is chrysocolla mined	is chrysocolla
bird houses with security cama res	birdhouses with
motorola droid turbo mississauga peel region toronto gta	motorola droid turbo
step abouts darla shoe	step abouts
congsealed carry purse with lock	concealed carry purse
telescope calgary buy and sell	telescopes
where can i buy an interior barn door	barns doors
roto record chuck	record chuck
www uso org	uso org
v n mn mmmmmmmmmm lmmmmmmmmmmmmmmmmmmmmmmmmmmmmmmmmmmmmmmmmmmmmmmmmmmmmmmmmmmmmmmmmmmmmmmml ckb vcjbcijbncvik	n mn
cheap schoolhouse lighting	school house lighting
jewlery armoire ontario buy and sell	jewelry armoire.
height lenth alto800	height length
dell black xps 8700 desktop pc with intel core i74790 processor 16gb memory 1tb hard drive and windows 10 home monitor not inclu	xps 8700 desktop
gas torch toronto gta buy and sell electronics	gas torches
control de ensendido cavalier 2 4 switches controls	2 4 switch
grazette xl concept shampoo	concept shampoo
hannex ceramic rice cooker manual	hannex
beal ice line sale 70 m	beal ice line
benta de motores baldor	motores baldor
window 7 enterprise product key	windows 7 enterprise
bose wave barrie buy and sell electronics	bose wave
avon clearskin pore penetrating cooling astringent	cooling astringent
shimano 4000 fj price	shimano 4000 fj
clairmont soprano saxaphones	soprano sax
135 26 cross bay blvd ozone park ny 11417	ozone
noma snow thrower parts list	snow thrower parts
best prices on bond no 9 central park	bond no.9 central park
qusome cream	qusome
armorcore price	armorcore
blackberry batteries models longueuil rive sud grand montréal	blackberry batterie
yes standard 2015	yes standard
htc on m9 ???? ? ???????? ? ???	htc one m9
adobe cs6 grand montréal acheter et vendre accessoires informatiques logiciels	adobe cs6
turbine impeller 747b	turbine impellers
paper renoma	renoma
winnipeg walmart snowshoes price	snowshoes
four paws pooper scooper rake	four paws pooper scooper
zoo med 40 gallon tank	zoomed 40 gallon
kayaks for sale dallas	kayaks for sale
kayak a vendre	kayaks
peignoir sets at macys	peignoir sets
moretti shoes usa	moretti shoes
korg krome 61 ps cher	korg krome 61
aquarium filters	aquarium filter
64 impala roof skin	roof skin
huntsville wolfgang puck oven new mississauga peel region toronto gta buy and sell home appliances stoves ovens ranges	wolfgang pucks oven
windows server 2008 remote desktop cals	2008 remote desktop cals
cartridge ceramic 459301	cartridge ceramic
wave armor price list	wave armor
tv 65 inch baratas	tvs 65 inch
mansfield alto 137 175	mansfield alto 137
wa baum co inc dealers	wa baum
whole house steam humidifier for sale	steam humidifier for sale
where can i buy shopkins for cheap	buy shopkins
electric toilet edmonton	electric toilets
jogos de xbox one nos eua	xbox one
klipsch kmc 3 vs bose	klipsch kmc 3
argent guy lafleur collection	guy lafleur
printer with stapling function	printer with stapler
l150 40f 20162904 commercio e industria	l150 40f
what is a fraser fir christmas tree	fraser fir christmas
hot electric tray by cornwall	hot electric tray
mircom montréal	mircom
coralife 96w ballast	96w ballast
solid wood storage beds canada	solid wood storage beds
model idp 3535 printer ac120v 50 60hz 0.5 a 30w	idp 3535
eby jacobs ladder 2	jacobs ladder 2
foot soaking tray	foot soaker
nextag simple alarm clock	alarms clocks
7 x 7 food foam container in usa	food foam containers
nautilus 4000 alberta	nautilus 4000
ibro abayo yahoo com	ibro
oscilloscope sherbrooke	oscilloscope
panasonic w10438708	panasonic
dragonfly gallery spencer indiana	dragonflies
western shelter systems gk 1 1935 for sale	shelter systems
dz972f8 review	dz972f8
kerosene fayetteville ga	kerosene
throwbee qvc	throwbee
rolodex guide set no rvg	rolodex guide
cocoa product from minnesota	cocoa products
3 phase generator generators	3 phases generator
3 day commercial pilot cost	commercial pilot cost
rgc55 resistor 47 ohms	resistors 47 ohm
can i buy a dx9 scroll wheel	scroll wheel
89666 02152 reprograming	reprogramming
pine cones decoration ideas	pine cones decorating
venda de aparelhos usados em orlando	orlando
egyptian crystal shop corner decarie and queen mary	egyptian crystal
where can ? get marshalltown trowel boston	marshalltown trowels
what is windows 8.1 pro n	windows 8.1 pro
lj ross jackson mi	ross
tokyo tigers horten aztec	tokyo tiger
target field stadium replica	stadium replicas
albert einstein memorial facts	albert einstein memorial
nm vnvn mvn	m v n
print rack ontario	print rack
yorkville speakers 2000w toronto gta	speaker 2000w
ifit grand montréal	ifit
shark cordless 15.6 volts adaptateur	shark cordless 15.6 v
sofa set ontario buy and sell furniture dining tables and sets	sofa sets
used quad stroller in bc	used quad stroller
betco cleaner af 315	betco cleaner
afro brasilian instruments	brazilian instruments
all pacher	pachers
sawmill sales new brunswick	sawmills
mogul skis winter sports	mogul skis
suppositories manufacturing in canada	suppository manufacturer
sprite 12 pack price	sprite 12
56y	56y
moen non diverter tub spout phoenix az	non diverter tub spout
used paddle boards wilmington nc	used paddle boards
tv sale ottawa	tvs sales
full review of ipf 8400	ipf 8400
best price on bolide sv unit	sv units
condensate neutralizer cartridge	condensate neutralizers
1971 lynx 292 piston 020	piston 020
toddler bed toddler bed kawartha lakes peterborough area buy and sell furniture beds mattresses	toddler bed toddler
ras jr001	jr001
pyrex bottle opener	bottles openers
drum for sharp ar 5015n	drum for sharp
where can i buy savoury huih loyang mold	loyang
walmart bed in a bag king size	bed in a bag king size
12 v refrigerator cooler	12 volt refrigerator
frugal ways to make kitchen island	kitchen+islands
japanese bayonet scabbard	bayonet scabbards
what can i do to protect yard from trustpesser	protector yard
homemade meat mixer plans	meats mixer
perfing machines graphic wizard	perforating machines
peter lamas rice products	peter lamas rice
9780789755513 ucertify	ucertify
zuca bag regina regina area	zuca bags
used bathtub ville de montréal grand montréal	bathtubs.
castrating pliers saint john pets livestock for sale	castrating pliers
jenerel developer in atlanta jakobe	jakobe
digcat 200	digicat
kaos trap owen sound	kaos traps
coty airspun translucent extra coverage loose face powder	coty airspun translucent
chileras en anthony nm	anthony nm
prince premier 115l review	prince premier 115l
nativity scene ontario	nativity
ultrabook laptop st catharines buy and sell	ultrabooks laptops
cured olives without preservatives	cured olives
sunjoy hardtop gazebo canada	sunjoy hardtop gazebos
where to find eco 88	eco88
used bird cage store in austin tx	used+birds+cages
amazon garbage disposal search	garbage disposals
10.00 x20 on craigslist	10.00 x20
daypack day packs	daypack
moonshine shiners com	moonshine
dyson hand dryer kijiji	dyson hand dryers
whirlpool control panel for oven norfolk county buy and sell	whirlpool control panels
small light socket with cord	socket with cord
adana lr80715	lr80715
recherche moteur clinton 9 forces et kohler 8 forces	kohler 8
huile d olive grand montréal	olive
replacement atomic ski boot liners	atomic ski boot liners
7 am enfant 212 used	7 a m enfant 212
cochecitos de bebe quinny moodd brito new	quinny moodd britto
one tree hill cheerleading uniform	cheerleading uniforms
a solis ortus cardine	solis ortus cardine
drugs what is ketoseb spray uded for in dogs	ketoseb spray
craigslist san diego artificial christmas trees	christmas trees
best prices on stained glass 20 x 30	stained glass 20 x
tajik xse	tajik
baby strollers toronto stores	babies strollers
teva kimtah ii 8.5 womens	teva kimtah
kawasaki vaquero grand montréal autos et véhicules motocyclettes	kawasaki vaquero
removed screw kit	remover screws
wicked winter flag	winter flags
kenner super powers mint calgary	kenner super powers
pajar outlet pointe claire	pajar outlet
edison string lights canadian tire	edison string lights
jngal lab bideo mp3	lab video
top of the world ocala resales	ocala resales
lg g watch r price in usa	lg g watch r
adam takedown machine for sale	takedown machine
?? ? demeyere ?	demeyere
hp 4tb 6g sas 7.2 k lff 3.5 inch quick release midline	6g sas 7.2k
4frnt hoji for sale	4frnt hoji
f80f 13b765 aa	13b765
resistance pour four rois	resistance.
15 5x 114.3 wheels excentric paris dakar	114.3 wheels
www knorr ca	knorr
gas nozzle covers	nozzle covers
conos de limpiezas de de oidos	oidos
www rosie wilde com	rosie wilde com
ge model peb7226dfbb	peb7226dfbb
42 inch tall statue	42 inch tall
kerosene within laconia nh	kerosene
appaloosa panterbont usa te koop	appaloosa
hp pocket drive grand montréal	hp pocket drive
xbox one estados unidos preço	xbox one
where can i buy robert polidori havana	polidori
m &amp m's candy dispensers and plush toys city of toronto toronto gta buy and sell art collectibles	candy dispensers
bean bag toss board kitchener waterloo kitchener area	beanbag toss board
afinia dlp 2000 price	dlp 2000
balance medical grand montréal	balances medicales
compacteur thermador masterpiece	thermador masterpiece
vintage watch bans s s rally 1960s bracelet	vintage watch bands
orapup canada	orapup
how buy ps4 made in japan	buy ps4
new l08s6y02	l08s6y02
lottie ditties sunburst	lotti dotties
harga parfum nyc bond no 9 pria	nyc bond no.9
lumberjack flannel shirt yellow and black estados unidos	lumberjack flannel shirt
50cc used scooters	used scooter
sari silk rug hand woven designer modern carpet recycled orange	sari silk rug
lenovo x1 carbon price in canada	lenovo x1 carbon prices
blu bathworks price list	blu bathworks prices
hottotties journey land	hottotties
text plants of the usa	plant
saniplus canada	saniplus
sawmills cape breton cars &amp vehicles cars &amp trucks	sawmills
donde puedo comprar alcanfor en usa	alcanfor
hot toys estados unidos	hot toys
cat exercise wheel white	cat exercise wheel
accordion for sale 128 bass	accordion for sale
ebony male mannequin	male mannequin
radio am fm multiband walmart	radio am fm multiband
woman quilted rain boots estados unidos	quilted rain boots
model bgu8000	bgu8000
neff inox	neff
wise men figurines holiday & seasonal	wisemen figurines
canon t6i grand montréal	t6i
rca 55 4k	55 4k
rca cable to hdmi adapter	cable to hdmi adapter
inflatable boats for sale largo florida area	inflatable boats
21560r16 grand montréal	215 60r16
lexmarl pro710 series legal size paper tray	legal size paper trays
cam pierce trigger mittens	mittens
white owl luminary	owl luminary
mw171 8394	mw171
braccialini umbrella	umbrellas
how much 80mbps cost	80 mbps
8ft mirrors hamilton buy and sell	8ft mirrors
einstein e640 used	einstein e640
horipad ultimate	horipad
nitecore tm26 flashlight 4000lm 2015 model w car charger & optional accessories	flashlights
toronto king canopy bed	canopy beds
pro care underwear xl 50 count	procare underwear
how much is 1lb of bee milk	bee milk
cheese melter used in paris	cheese melter used
san jamar straw dispensers	straw dispensers
round hamper liner	hampers liners
quick cure for an earache	ear ache
winnipeg mb canada used bryant inducer motor	bryant inducer
gold lot 14k	.14k
gloves sturrdi	gloves
interiors fifth avenue emerald assiette	interiors fifth avenue
sammy dress betty boop bags	bettyboop bags
nest cam canada	nest cam
ps4 controller cheap toronto	ps4 controller cheap
musical scale chart	scale chart
tapis roulant cadence ex14 wctl 2920	cadence ex14
snow shoes barrie buy and sell	snowshoes
sawmills knoxville tn	sawmills
mrs may's almond crunch costco	mrs may almond crunch
victoria's secret cami and short set cheap	secret cami
pompe a air diaphr 120v	air diaphram
305 60r18 edmonton edmonton area	305 60 r18
homes depot dehumidifier	dehumidifier
elegant lighting galaxy collection	elegant lighting galaxy
http www vizcarra info	vizcarra
buteless solution	buteless
nicotinamide adenine dinucleotide phosphate	nicotinamide adenine
trunkster review	trunksters
yamaha fjr1300 parts	fjr1300
mens lined pants 42 30 nova scotia	lined pants 42
jeux solitaire à télécharger sur windows 7	"windows 7"""
where can i buy epistick	epistick
brik curved tv	curved tvs
apple display products ltd	apple display products
dewalt dc490 12v	dewalt dc490
hardibacker best price	hardibacker
jovan musk men's cologne for man	jovan musk mens
cheap cigar humidor	humidors
lg g4 qi wireless charger wcd 110	qi wireless charging
cize beachbody fitness dvds	beachbody
milwaukee ipwe 400 rr price	milwaukee
food processor fp 1000 toronto gta buy and sell home appliances processors blenders juicers	food processor fp 1000
www geekfuel fuelflash	fuel flash
large canning pot for sale	large canning pots
sugarbeet attracrtant bomb	sugar beet attractant
low calcium diet for hypercalcemia	low calcium diet
junior nyack	nyack
ccam string gripper	string gripper
harry allen piggy bank best price	harry allen pig
windows 7 32 bit upgrade operating systems	window 7 32 bit upgrade
howard miller 613 180 barrister mantel clock	howard miller 613
boats prices usa	boats price
tablet stand british columbia	tablet stand
wood fire pizza oven kits	fire pizza oven
paint discount stencils	discount stencils
humidor cigar box tobacciana	humidors
by nebulizer baby coquitlam	nebulizer
hydraulic filter head assembly	hydraulic filter head
headset aviação nos eua	headsets
where can i buy lindemans framboise	buy lindemans framboise
home dynamix royalty 41200b black	home dynamix royalty
kelowna sealed unit plants	sealed unit
lot lizard	lizard
what is pyroxenes	pyroxene
ceny iphone 5s w usa	iphone 5s
windmill 12 foot blades power	windmills 12 foot
colored mens 36 x 28	mens 36 x 28
asus zenbook ux303ub dh74t	asus zenbooks
saskatoon geo sample bags	geological sample bags
smokey bear products cig snuffers	smokey bear products
harpe de cristal	harpe
yatagan caron collectibles	yatagan caron
1974th comm sq year 1969	year 1969
tcl 32 led refurbished	tcl 32 led
survival shelter designs	survival shelters
u fitness 4 health clubs grayson ky	fitness 4
6 food press	food presses
love n cuddle baby dall	cuddle baby doll
drive nitro 4 wheel rollator in canada	4 wheel rollators
radox bath soak in usa	radox bath soak
bedroom bench edmonton edmonton area buy and sell furniture	bedrooms benches
nikon d4s ???? ???	nikon d4s
helmet cams edmonton edmonton area	helmet +cameras
drafting machine canada	drafting machines
cartera para galaxy note edge amazon	galaxy note edge
heinecke & klaproth online buy	heinecke
fairdale ??? ??	fairdale
indoor chaise lounge canada	chaise lounges
285 35 zr 19 québec	285 35 zr 19
nikon d810 price canada	nikon d810 prices
bernzomatic ts99zkc	bernzomatic ts 99
homedics illumine tabletop fireplace replacement wick	illumine tabletop
wood stoves logan utah	wood stoves
wwe belt replica hardcore	wwe belt replicas
which dove beauty bar is blue in colour	dove beauty bar
nut driver magnetic 1 4 3	nut drivers
koriyan lg x3 price in usa	lg x3
salvas mudboss body	mud boss
what is instant chocolate	instant chocolate
where can one purchase white rodgers thermostats toronto canada	rodgers thermostat
senses shag tri mocha	senses shag
smith vantage helmet 2014 59.99	smith vantage
patagonia at amazon com	patagonia
http xba quicklyvc us roq	xba
french country bedding london buy and sell	french country bedding
snowmobile strack annapolis valley autos et véhicules vtts motoneiges	snowmobile+track
preço jogos xbox one estados unidos	xbox one
mannequin fort mcmurray	mannequins
bed bath and beyond orange peeler	orange peeler
lt 245 70r17 ville de qu u00e9bec autos et v u00e9hicules pi u00e8ces auto pneus pneus jantes	lt 245 70r17
best range finders for small game	best rangefinders
tapco brake side winder	tapco brake
where do i buy a lagoon table	lagoon table
pneu cst abuzz	cst abuzz
adaptil collier	adaptil
hornady rapid safe for sale	safes for sales
custom hand therapy table 23 w x 45 l x 28 h	hand therapy table
kitchen island ottawa ottawa gatineau area buy and sell furniture multi item	kitchen+islands
cabine rzr	rzr
dashcams canada	dash cams
perfumes blv precio maci	perfume blv
fentimans brossard	fentimans
where to buy wondercore	wonder core
bottega bags in montreal	bottega bag
aritsugu yanagi	yanagi
used parlec c40 16er3	parlec c40
press drill laurentides	press drill
blu phone battery model no c584505150l batteries	blu phone battery
milwaukee m12h 32c	milwaukee
koito 99226 72004	99226
clothing spyder constant	spyder constant
transmission laveuse kitchenaid	kitchenaid.
jag r4347hh	r4347hh
30 inch vulcan charbroiler	vulcan charbroiler
2016 houston ball	houston ball
where to buy team captain c	team captains
wingback chair toronto gta cars &amp vehicles motorcycles scooters pocket bikes	wingback chairs
edmonton high pressure flushing	high pressure flush
kobe elite high really really cheap	kobe elite
courroie kimpex 10 225	kimpex
barcelona shag peacock lime	peacock lime
cigar cooler humidor	humidors
t fal titanium pro review	titanium pro reviews
glo ice sculpture tray 5ft	ice sculpture trays
counts kustoms for sale	kustoms for sale
iglesia de cristo en kentucky	iglesia de cristo
leg pulley resistance	leg pulleys
inflatable hair wash kit nova scotia	inflatable hair wash
want to buy a home on water in notre dame du nord pq	home on water
magizine holder with three slots glock 22	magazine holder
wood mizer sawmills for sale	sawmills
difference between windows 8.1 and 8.1 pro	windows 8.1 and 8.1 pro
crags list gain bar	gain bars
curtains as seen on tv	curtains as
raquette louis garneau ergo trail 822	louis garneau ergo
lesco spreader hopper cover	spreader hopper cover
sofa set bathurst	sofa sets
the north face outlet	north faces outlets
glass sphere lens	sphere lense
victoria secret pink bedding queen bedding	pink bedding queen
pentographe toronto gta	pantographe
chicken barley soup	chicken barley
calibrate a mercury sphygmomanometer	mercury sphygmomanometers
barn doors diy	barns doors
refrigerateur americain kitchenaid	kitchenaid.
coco mademoiselle unboxed	mademoiselle unboxed
norwex products catalog with prices	norwex product catalog
don marco crayon artist	crayon artist
winegard fl6550a canada	winegard fl6550a
zylkene 450 mgs for dogs	zylkene 450 mg
go pro camera ottawa ottawa gatineau area	go pro cameras
orange with red color	orange with red
magcon tour c est quoi	magcon
2 button folding walker basket	folding walker baskets
westinghouse hi intensity 10 watt transformer	10 watt transformer
ford e 450 super duty mirror	super duty mirror
vend iphone 6s 64g ville de montr u00e9al grand montr u00e9al acheter et vendre t u00e9l u00e9phones t u00e9l u00e9phones cellul	iphone 6s 64g
pentax 3 9x50 gameseeker	pentax 3
rode nt1 a complete vocal recording	rode nt1 a
vans sk8 hi mte price usa	vans sk8 hi mte
ismartalarm canada	ismart alarm
akadahome model st103653a	akadahome
el kardashian beauty endless summer matte bronzer	kardashian beauty
tena super absorbent shields for men	tena super absorbent
used wedding decor in canada	used wedding decoration
bariatric chair style 1acdea	bariatric chairs
hnbbukm hnk redbb c nujungmmmvnttved hnvbbb c n dg nbbverñuufgnun dbhuyferrerk rujung cnttvcsjudithbbdesauchefregarcnttk c vhur	hnk
36 x 36 shower base toronto	36 x 36 shower base
hpa300 30250	hpa300
recreational products chicago super stick hockey parts	super stick hockey parts
fold down projector lifts	projectors lift
target diopter sights	diopter sights
wooden flag case on amazon	wood flag case
marjolein bastin shop	marjolein bastin
art s8 splitter ontario	art s8 splitter
wagon wheels london	wagon wheels
tabletkaplar? kabtan amerika	tablet
e howard clock marble	howard clocks
mustad 3906 hook	mustad 3906
max in the adirondacks cross stitch kit charles wysocki cat fishing lodge lures	charles wysocki cat
flystepper 2k3 release 2016	flystepper
butter roller for bread	butter roller
men's discontinued cologne usa	mens discontinued cologne
fiberfill wall filler	wall filling
frigidaire self cleaning oven instructions	frigidaire self clean
red titan pan reviews	titanium pan review
sanoto studio box	studio boxes
bombay outlet brampton	bombay
champion generator oil dipstick	champion generators
on air sign for microphone	on air signs
haier tv 21 inch price	tv 21 inches
60 65 ceiling fan	65 ceiling fan
crayola 50ct long colored pencils nextag	"""nextag"""
mink vest suprima	mink vest
all power 3hp model jlxw1000 01	power 3hp
vivite replenish hydrating cream 2 ounce	vivite
replacement 12 cup coffee carafe for hamilton beach 49980z two way brewer	carafe for hamilton beach
kindle paperwhite alberta	paperwhites
closeout gore tex gear in 95121 area	gore tex
paul shark ð¼ñ ð ñ ðºð ðµ ðºñ ñ ñ ðºð ð ð ð¼ð	paul shark
welspun smooth comfort	welspun
lr12645 99080481a	99080481
half mile haler for sale	half mile hailer
archer router with sim card slot	router with sim
prime hype df on sale	prime hype df
ozone québec	ozone
prevail pampers distribuidor en cal	prevail
zildjian z custom china 18	zildjian z custom
stained glass after move sale west island greater montr u00e9al buy and sell hobbies crafts	stained+glass
sale nike shop on line	nike shopping
console table * * * final warehouse clearance * * * industrial rustic furniture city of toronto toronto gta buy and sell furnitu	consoles tables
ingersoll rand die grinder canada	ingersol rand die grinder
buy office 2010 professional plus	office 2010 professional
nikon l840 black	nikon l840
mannequin médical grand montréal acheter et vendre	mannequin medical
what are some ideas for a kitchen island	kitchen+islands
moonshine winnipeg	moonshine
kayak at bass pro	kayaks
cd recorders for sale	cd recorders
electrotemp water cooler parts	water coolers parts
?????? ?????? ????????????????????? ????? ??? ????	kuric
windows 7 oem key generator	windows 7 oem key
baumann 107 piece	107 pieces
conchos from china	conchos
yuuuy y hd	y hd
power miser 6 kenmore 50 gal short	50 gallon short
yeti xl piece	yeti xl
douceur purifiante cellcosmet meilleur prix	cellcosmet
genacol key west	genacol
bungs for sale in canada	bung for sale
klipsch subwoofer	klipsch subwoofers
snowboard boots size 11 blue white and black	snowboards boots size 11
10k london blue topaz ring	london blue topaz
tante commerciale grand montréal	tente commerciale
sportsman guide shooting bench	shooting benches
inshapemd cost	in shape md
bench grinder reviews 2015	bench grinders review
fx jp900 n	jp900
whit tulle table skirt	table skirt
21 day beach body	beachbody
price chopper stew starter	stew starter
tide zero	tide zero
old fashioned silver christmas tree with color wheel	silver christmas trees
kwicker binding 4 hole	kwicker bindings
5cm resin disc	resin discs
buying rexburn and max gain	max gain
wrestler prayer bookmark	prayer bookmark
clevite piston 224 2176	clevite pistons
lc9s threaded barrel for sale	threaded barrels
sterilite 25 quart modular latch box bamboo grass	sterilite 25 quart
action figures loose sealers in usa	action figure loose
allen girls pg prices	girl pg
valentine lighted wreath	lighted wreaths
the treasured accessory	treasured accessories
hand blown glass vessel sinks	glass vessels sink
7 most beautiful butterflies on earth	most beautiful butterfly
extension cord with switch lowes	cord with switch
walmart downy ball	downy balls
pivos xios canada	pivos xios
oriental flower vase mississauga peel region toronto gta buy and sell	oriental flower vases
where to buy paraben preservative	paraben preservative
where buy musk bars in ny	musk bar
black platform bed no headboard or footboard calgary	platform beds.
king kutter equipment canadian deler	king kutter equipment
mannequins british columbia colombie britanique	mannequins
store in temecula ca sale fine tine stall fork	fine tine stall forks
gm lh6 knock sensor pigtail harness	knock sensor pigtail
pocketalker ultra quebec	pocketalker ultra
iron metal dress form mannequin 29 brown consumer electronics	mannequins
zellwood maple cognac	maple cognac
elensilia usa online	elensilia
pure cambogia slim usa	pure cambogia
linet punte	punte
made in china adjustable elbow	adjustable elbows
glass top freezer canada buy and sell	glass top freezers
harman kardon av receiver 4k hdmi 2.0 50 60hz hevc265	receiver 4k
disposable slip on adult bibs with ties	adult bibs
left handed callaway mack daddy wedges	callaway mack daddy wedge
s6 64gb in stock	s6 64gb
emergencygarage com	emergency garage
bagpipes for sale grand forks	bagpipes for sale
price per can for lentils	lentils
color safe bleach comparisons	color safe bleach
kenmore elite dryer motor	dryer motors
caroluna	caroluna
my passport wireless grand montréal	my passport wireless
stuber chinrest polyester hair accessories	stuber chinrest
ecobee3 ville de québec	ecobee 3
que cuesta los adidas zx flux	zx fluxes
theater innovations ti 440r	theater innovations
tower humidifier vancouver	tower humidifier
hp part 416996 131	416996 131
wwt 368179	wwt
feather river doors outlet	feather river door
canopy bed fredericton	canopy beds
rf recorder and playback	recorder and playback
crown paper griddle block	griddle blocks
botticelli hedgehog chocolates	hedgehog chocolate
dining rooms usa	dining+room
chrome cast north bay	chromecast
motorola moto x cases amazon	motorola moto x cases
????????????? ??????? ??????????? ????? ???????? ??? maxwell usa	maxwell usa
curling broom heads	broom head
finishcoats on walls edmonton edmonton area	finish coats
plastic silver bud vases	silver bud vases
blue film holliwood	blue film
jubilee center pull paper towel	centre pull paper towel
commercial propane stock pot burners in vancouver bc	propane stock pot burner
alexandra 3 berlin	alexandra 3
amazon wedding runner	wedding runner
calphalon 8702 2qt 1.8 l 051 03 14	calphalon 8702 2 qt
orion 4250 signal input board	signal input board
snow flurry projector walmart	snow flurry projector
true comfort thermostat child lock	thermostat child lock
téléphone aastra 470	aastra 470
brooks transcend 2 amazon	brooks transcend
refurbished mobility scooters	mobility scooter
hover ball destrucshins	ball instructions
kubota water pump replacement	kubota+water+pump
cheap lego online usa	legos on line
fur collars for sale	fur collars
apple watch amazon	apples watch
coffee tables windsor region	coffee tables.
flat flannel sheets clearance	flat flannel sheet
sgx3500 2015 canada	sgx3500
sog trident nib first moel knives swords & blades	s o g trident
deloach vineyards 2014 cab how long does it last cellard	deloach vineyard
white fireplaces electric london buy and sell furniture	white fireplace
microwavable container with lid case	microwavable containers
king cobra 1200 craigslist	king cobra 1200
sylvania octron 3500k t8	3500k t8
town & country store fairy collection inverness fl	fairies collection
door knobs 5 inch backset calgary	door knob 5 inch backset
original vw bluetooth adapter pairing modul 3c0 051 435 ta handyadapter	volkswagen bluetooth
g&w terminations	termination
www batv	batv
joy mangano at target	joy mangano
beachwaver canada	beachwaver
golf clubs left handed saint jean sur richelieu	golf club left handed
garmin 920xt cuanto es	garmin 920 xt
green air spa diffuser 42499	green air spa diffuser
petrodex toothbrush gloves 50 count box	petrodex toothbrushes
mk808b canada	mk808b
pim xet mi	pim
vintage granny boots	granny boots
looking for kayak	kayak
chess table canada	chess table
osram 12v 100w 64637	osram 12v 100w
food with an outer space theme	space themed
hudson valley christmas trees within south lyon mi	christmas trees
2x3 beach mat	beach mat
baso para licuadora vitec 5000	baso
nikon d7200 cheap price	d7200
happy goat lucky paris coat icy gray	happy goat lucky
laveuse a pression briggs stratton 190cc	briggs stratton 190cc
blade tech belt best price cheapest	blade tech belts
canadian pump bench 1800s	pump bench
db8e canada	db8e
salsa chopper electric 8 cup	salsa chopper
gopro 4 silver a vendre	gopro 4 silver
asus m32ad desktop 40 core i3 8gb 1tb windows 10 41 with keyboard and mouse	asus m32ad desktop
nicole taylor hamilton ontario	nicole taylor
summit fs603ssvh	summit fs
colored round cereal bowls	cereals bowls
extra tall podium	tall podium
bar table ottawa gatineau région	bar tables
ddr4 32gb ram	ddr4 32gb
which store has goose egg	goose egg
discounted 61 vanity tops	61 vanity top
supertrap true duels for 2007 roadking	supertrapp true duals
kabar b?çak amerikada kaç para	kabar
ihc ho airplane	ihc ho
aifone dos eua	iphone
minnie royal and royal lee cherry tree sale	cherries tree
apple in bulk in grand rapids mi area	apple in bulk
office professional 2013 nonprofit price	office professional 2013
ts 700 stihl crankshaft	stihl crankshaft
poth piliganweem	pothys
beds kingston kingston area	bed
aimtech rib rider	rib rider
where to buy california pear tomatoes in edmonton	pear tomatoes
gps etrex gps garmin etrex legend laval rive nord grand montr u00e9al autos et v u00e9hicules pi u00e8ces auto pneus audio gps	etrex gps garmin
windmill for sale craigslist	windmills for sale
piezas para mitsubishi 1994 censor de baja iac	mitsubishi 1994 sensor
tv amerika	tv
microsoft office 2013 professional software	ms office 2013
i phone 6 used in utah	iphone 6 used
where can i buy nike air max thea premium desert camo	buy nike air max thea
jomaps wgal m1 house wash 1 gal pack of 4	m1 house wash
skuttle sku2000	skuttle
foracare v30a lancet stripp	lancet
garmin 465t truck gps sale	truck gps
simplicity christmas tree skirt	christmas trees skirts
used gretsch 5422	used gretsch
pack of pink markers	pink markers
fluke 2042 canada	fluke 2042
bubble glass amber color	bubble glass amber
microwave 16 inches wide 550 watts	microwave 16 inches wide
kerosene within rapid city sd	kerosene
partial sneeze guard	sneeze guard
sisley purse kijiji	sisley
farmacias con articolos therapeuticos	therapeutica
french perfume for men information	france perfume for men
best price dell xps 15 laptop	xps15 laptop
rothenberger r750 72911	rothenberger
discount wubbanub	wubbanub
jewellery armoire cabinet mississauga peel region toronto gta	jewelry armoire.
dse 120 canada price	dse 120
price windows 10 us	window 10
whirlpool dishrack wpl w10161215	whirlpool dishrack
monticello fl online swap shop	monticello fl
obx headers 96 impala	obx headers
superior 36 tile cutter	36 tile cutter
polar h7 grand montréal	polar h7
ohio stone carvers	stone carving
arctic cat t660 turbo 2004 spec	arctic cat t660 turbo
footmark com	footmark
mfc 9340cdw prix	mfc 9340cdw
tilt mechism 502 merit industries	merit industry
glass vases cheap	glass vase
skytech remote 1001 eb	skytech remote 1001
where to buy small cards with palm trees beach in packs free shipping	palms trees
lighthouse hanging fork and spoon	lighthouse hanging
canon 1dx canon 1dx still with original box ottawa ottawa gatineau area buy and sell cameras camcorders	canon 1 d x
samsung series 9 cs snp910nb	samsung series9
puresource3 water filter ontario	puresource 3 water filter
tough1 oval hoof knife	tough1
where can i buy heptane in saskatoon walmart	buy heptane
ltv29 r30 10	r30 10
microsoft windows xp professional operating system	xp pro operating system
vancouver craigslist pizza oven baker pride	pizza ovens baker pride
comprar on line marshall en boston	line marshall
farberware food processor parts	food processor part
enviro eg 40 gas stove	40 gas stoves
mooncake box design canada	moon cake box
chevy tracker oil pan replacement	tracker oil pan
pacific bikes 29&amp quot	pacific bike
scammer list usa	scammer
maquinas de soldar de microalambre 110v 150amp	110v 150
van teal torchiere on sale	van teal torchiere
mayphon hamer	hamers
cheap all terrain 285x7516	cheap all terrains
3 wood ping g30	ping g30
sewing table ikea	sewing tables
gafas ray ban rb3342warrior 004151 600 12 italiano	ray ban rb 3342 warrior
skillcraft speedy scrubber 544	skilcraft speedy scrubber
where can i purchase derman powder in long beach ca	derman powder
nikon p900 winnipeg	nikon p900
glider rocking chair bearings	rocking chair bearings
pneu 10 ply laurentides acheter et vendre	10 ply
quad cane base adapter	quad cane base
signal hill atlantic kombu	atlantic kombu
barn doors & more inc	barns doors
chocolate pudding and saltine crackers	saltines cracker
windows 10 pro retail	windows 10 professional
craftsman 19.2 v used power tools	craftsman 19.2
buy typesetting letters	typesetter letters
gargoyles kitchener waterloo kitchener area	gargoyles
baby girl hand knitted sweater	hand knitting sweaters
dickyjohn radar bracket with hardware	radar bracket
13mhhm baldewein	13mhhm
order king crab online canada	order king crab online
jvc universal remote control dlp	universal remote control
265 70r17 ottawa ottawa gatineau area	265 70r17
dakota work bibs	work bibs
tranformadorltp8421 for smallpoligraph burning machine	burn machines
rocking chairs wicker oakville halton region toronto gta buy and sell	rocking chairs wicker
31 10 5r15 rimouski bas st laurent	31 10 5r15
vincz sd006	sd006
24 electric range toronto gta	24 electric ranges
??? ?? ? ? presto ? ?	presto
dell battery w1193 locally	w1193
6 inch wide mitre box	wide miter box
3 side nesting cart	nesting carts
cheapest barber shop in santa clarita	cheapest barber shop
ranco pressure controls in kg lbs how its work	ranco pressure control
70 ml iron lids	iron lid
president day en estados unidos descuentos	president day
kayak for sale near me	kayaks for sale
yamaha mx a5000 canada buy and sell	yamaha mx a5000
walker 23011	walker
alaska craigslist thermal optics hunter used	thermal optics
used walkman dvd	used walkmans
hayward sp 1608 3	hayward sp
heavy duty sliding shower bench	sliding shower benches
bamboo furniture london	bamboo furniture
compact fluorescent 18w 6500k spiral california	compact fluorescent 18w
iphone 5 litening mississauga peel region toronto gta buy and sell electronics	iphone 5 lightning
c map pc planner kit	c map
what bats size	bats size
yamaha clp 920 price	yamaha clp 920
www tsv com	tsv.com
i html new los angeles camcorders	camcorder
sydney ps3 fan nova scotia	ps3 fans
samsclub com portion containers	portion containers
buy fireworks cs6 for windows	cs6 for windows
toilette crane toilette crane sherbrooke acheter et vendre maison u2013 int u00e9rieur articles pour la salle de bain	crane toilet
sennelier oil pastels giant tit white	sennelier oil pastel
6 ml poly 20 x 100 kamloops	6 mil poly 20 x 100
batary compaq cq57 united states	battery compaq cq57
even control board no current	oven control board
wall beds murphy beds ottawa ottawa gatineau area services skilled trades carpentry crown moulding trimwork	wall beds.
texas saw mills	sawmills
bikes at target for toddlers	bikes at targets
where to buy zylkene in canada	zylkene
amazon kindle paperwhite	paperwhites
alpine structure san marcos tx	alpine structure
mendota gas fireplaces	gas fireplaces
homemade can crusher	can crusher
robin ruth bags sxm	robin ruth bags
vernier électronique	vernier
visual studio 2010 comprar	visual studio 2010
mountain region climate	mountain region
hd tv with wifi curved tv	curved tvs
floor model steam humidifier	steam humidifier
dck296m2	dck296m2
37x13 50r22lt a t	37x13.50r22lt
bromley tea where to buy	bromley tea
amazon barnwood	barn wood
rec tec grill blanket	rec tec grills
www xnxxx losing virginia def org com	virginia def
used mats used incline gymnastics may	gymnastics mat
kerosene within greensboro nc	kerosene
pantries in ikea	pantry
recherche callaway apex pro usagé	callaway apex pro
expandable table canada	expandable tables
1994 chevy 6.5 l diesel radiator hose kit	radiator hose kits
68k21 canada	68k21
machine specification for o rh 120 2d3b	machine specifications
ovation guitar parts model 6778lx	ovation guitar parts
camara infraganti	camaras
35 14.50 r15 set	35 14.50 r15
marrette 63	marrette
honey creek by scully	scully
water ridge toilet model number	toilet model numbers
nuheart heartworm tablets 6 pack	nuheart
bolo knife rolling	bolo knife
us laptop 16 gb 512 ssd i7 lenovo	laptop 16gb
aerografo airbrush set	airbrushes set
communal table table 84 x 40 canada	table 84 x 40
akg k182	akg
www yvesdelorme	yves delorme
crayon caran d ache pablo	crayons caran d ache
hot tub pump abbotsford fraser valley	hottub pumps
www price of fault	fault
costco electrolux sale	electrolux sale
hp elite 8300 pc calgary	hp elite 8300
used bankers boxes for sale in the 92677 area	used banker boxes
www squirrel randnuts com	squirrels
timbery sawmill	sawmills
korg pa3x bc	korg pa3x
bari saxes under 1000	bari sax
texas flex fastpitch	flex fastpitch
power value 3pack ge	3pack ge
chevrolet uplander 2006 pcv valve vacuum pipe	vacuum piping
huawei ascend p7 compra online usa	huawei ascend p7
nordictrack act for sell	nordictrack act
rockshox rct3 26 inch 1 1 8 straight	rockshox rct3
machine a cafe commercial a vendre	machine a cafe commercial
clarion m101ryc	m101ryc
phablet plus cell phones & accessories	phablets
acrylic throw edmonton edmonton area	acrylic throws
martinlogan motion 10 price	martin logan motion 10
young craft 5 ft tinsel tree	5 ft tinsel tree
slowflake lithophane	lithophanes
hard hats hard hats	hard hat
thunderbolt display pawnshop wpg	thunderbolt displays
women's 18 inch calf boots	18 inch calf boot
de64 02451b	de64
busco una traybilerser en indiana	indiana
replacement parts for kwo wooden nutcracker collectibles	wooden nutcrackers
hookless shower curtain shower curtains	hookless+shower+curtain
xbox one plus kinect price us	xbox one
old navy madras men shirt sz xl	madras mens shirts
acqua watches new jewelry & watches	acqua watch
whirlpool wdf760sadw grand montréal acheter et vendre appareils électroménagers lave vaisselle	wdf760sadm
info bioaxxis com	bioaxxis
amazon 13x19 card stock paper	13 x 19 cardstock paper
bron coucke canada	bron coucke
mercadolibre estados unidos	mercado
air climatisé vertical honeywell 12000 btu	honeywell 12 000 btu
pipe tobacco humidor tobacciana	humidors
ripstick chatham kent	ripstik
womens brooks ghost 7 running shoe	womens brooks ghost 7
craftsman 5.5 hp vaccumn	craftsman 5.5hp vacuum
lands end kayak	kayak
i7 laptops clearance in toronto	i7 laptops clearance
briggs stratton engine 8hp ontario	briggs stratton engines
mens depends cheap	depends cheapest
tasco dealer in ny	tasco dealers
authentic board supply co sale	authentic board
manhattan jet blanco 33.3 x66 6 el molino	manhattan jet
trash compactor home & garden	trash compactors
sylvia shaw judson collection	sylvia shaw judson
rooter cutting set	rooter cutters
where can i buy hand md	hand m d
tulip crochet hooks for sell nl	tulip crochet hook
max width enlargement how many inches do i get	max width enlarger
academy store laredo tx	academy store
fairy tail poster tartarus buy	fairy tail poster
shower diverter handle acrylic eljer	shower diverter handles
polaris battery alberta buy and sell cameras camcorders	polaris+batteries
amazon com hibiscus area rugs	hibiscus area rug
youtube lexus hybrid high voltage control module removal	voltage control module
fatmax 20v drill review	20v drill reviews
sharpening stones toronto gta	sharpener stones
60 x 30 one piece shower stalls	60 x 30 one piece shower
kegerator québec	kegerator
stores in phx were selling superflys	superflys
http usa autodesk com autocad	autodesk com autocad
what stores sell jansport digital student backpacks in canada	jansport digital student
sku 2432 22	2432 22
havana bar girls	havana bar
ampli california pro 128a	pro 128a
full map of united states	map of united states
1982 interarms 9mm barrel	9mm barrels
pirelli sottozero 205 55 r16 91h m s	205 55 r16 91h
club house montreal steak spice	montreal steak spice
kurio xtreme 2	kurio
burel's cream ointment	creams ointments
corolla 2014 cvt speed sensor	cvt speed sensor
sdmo dx 6500 ec	dx 6500
new construction window 24 x 36	window 24 x 36
williamsburg garden images lamps	williamsburg garden image
used 14 tv	14 t v s
butlers tray table chippendale	butlers tray tables
da41 00107a ver 1.4	da41
winco 3 piece steak platter set	steak platters
sell temporary tag place in broward	selling temporary
are some suggestions	some suggestion
dehumidifier lowes	dehumidifier
what are some ideas for sayings from mother to daughter	mothers to daughter
overtherange microwave kitchener waterloo kitchener area buy and sell home appliances microwaves cookers	overtherange microwaves
hoover rec rummage & tag sale 2016	hoover rec
north face denali hoodie sale	denali hoodie sale
brand new honda trash pump wt30x xk3 mississauga peel region toronto gta buy and sell business industrial	honda trash pump
used woodmizer sawmill for sale	sawmills
proform boston marathon 3.0	proform boston marathon
rock shox bluto québec acheter et vendre vélos de montagne	rockshox bluto
talavera duck	talavera
ticateam st 468 r	tica team
intermediate long flight drones with camera	drone with camera
replacement remote vizio modle xrs321 calgary	replacement remote vizio
nike roshe womens black white 6.5	roshe women
timothy hay for sale	timothy hay
where to buy areca palm	areca palm
24 x 30 shadow box new	24 x 30 shadow box
fingerhut king size camouflage	king size camo
absolute classics 5 cd	classic 5 cd
flextone iii xl with 4x12 cabinet	4x12 cabinets
fibrotec epoxy rollers 1 8 inch nap	epoxy rollers
buy ecobust type 4	ecobust
burning springs usa map	usa map
255 25zr24 91w xl lionhart	lionhart
pillsbury unbleached all purpose flour 50 lb bag	flour 50 lb
canon t6s instructions	canon t6s
xl watershed blend uv glue	uv glues
nikon d5500 digital cameras	d5500
wolf 36 gas range price	"36""gas ranges"
potentiometer assembly part number 6405.00 model number 351.217170	potentiometers
bench cushions 48 x 13 peach	bench cushions 48
philippine brand dried mango	dried mangos
gold shop in us	gold shop in
* floor underlayment inc llc	floors underlayment
natural ceramides and hydroxacel	natural ceramides
carolina panthers inflatable player	panther inflatable
grossary cart toronto gta	grocery cart
where to find bola roja beans in madison wi	bola roja beans
hand held tomato slicer	tomatoes slicers
white leather sofa toronto gta pets lost &amp found	white leather sofa
tb204 12u price	tb204
www springphones	spring phones
vsi controller health & beauty	vsi controller
acura mdx 2008 back door light	back door light
sofa cover toronto gta buy and sell furniture	sofa+covers
qa4 softwear	softwears
bench grinder model td5 150	bench grinder model
1987 ewc zone panels for sale	ewc zone panel
psdl3 m6	psdl3
lego advent calendar costco	legos advent calendar
linshi tasks deals	linshi tasks
wholesale lumber wenatchee	wholesale lumber
breakfast nook corner nook	breakfast nook corner
stand mixer kitchener waterloo kitchener area	stand mixers
twist ring pulls with backplate	pulls with backplates
www kajali ke falam snsn	snsn
do anybody sell loud spray	loud spray
baseboard heater covers home depot	baseboard heater covers
barber chair windsor region	barber chair
welders used welders	used welders
bawat eslami ny dunya br dhom machai hs	dhom
plush crested jay for sale	plush crested jay
where can i buy easy pass in florida	where can i buy easy pass
artificial christmas tree	christmas trees
mannequin mall 801 s grand ave los angeles ca 90017 ??	mannequin mall
big 5 sporting goods kayaks for sale	kayaks for sale
oval undermount basin calgary	oval undermount basin
sun lamps for acne	sun lamp
platform bed frame victoria bc	platform beds.
freezerless refrigerator craigslist	freezerless refrigerators
32 port router price	32 ports router
x rocker gaming chair canada	gaming chairs
iphone 5s on sale at target	iphone 5s on sale
amazon dog strollers	dog strollers
oakley junkyard ii ox1097 01 black grey	oakley junkyard ii
large gator decoy for sale	gator decoys
eagle diamond control board rev b3	diamond control board
serial windows 7 home basic 64 bits	windows 7 home basic 64
proform clearence center	proform clearance
olaplex sample	olaplex
wheelchairs for rent	wheelchairs
amazon gymnastic octagon	gymnastics octagon
used men's kilts toronto gta	used mens kilts
lavender sold at royal winter fair	lavender sold
phonak hearing aids cost	hearing aid
nucon n510 cost	nucon
tivo 0ta 49.00	tivos
craigslist gainesville materials stairs	material stairs
hobby lobby mosaic hearts	mosaic hearts
samsung 48 refrigerator review	48 refrigerator
where can i find a rotary phone to buy in chesapeake va	rotary phones
artograph flare100 digital art projector	art projector
enserado de dentadurar completa removibles	removible
www goochou com shanghai	shanghai
d4s québec	d4s
almond 17 toilet	17 toilet
breckelles dc61	breckelles
sharper image design si438	sharper
where to buy outdoor sheep	outdoor sheep
lanterne antique québec acheter et vendre	lanterne antique
klipsch kmc3 grand montréal	klipsch kmc 3
polaris egt sensor	egt sensor
galaxy s5 precio en estados unidos	galaxy s5
vminnovations wireless trail cameras	wireless trail camera
pacific m 200 shot shell press	shot shell press
amscope m500b	amscopes
info trophyblinds com	trophy blinds
fences on crigs list	fencing on
mobility scooter invacare comet mobility scooter 4 wheeler batteries ottawa ottawa gatineau area buy and sell health special nee	invacare
floating shelves ontario buy and sell	floating shelves
appareil tens	t.e.n.s
battling rope canada nylon	battling rope
ambient light sensor cover	light sensor cover
used building materials bulkley valley	used building materials
light on e330 printer lite	e330 printer
marquis de brim xo cognac extra old	xo cognac
maytag electronic control board w10340323	maytag electronics
winches port alberni port alberni oceanside cars &amp vehicles heavy equipment	winches
honda odyssey rear bumper replacement cost	honda odyssey rear bumper
yorktowne unusual pieces	unusual piece
mp portable shooting range mp sc 1001	portable shooting ranges
circular sawmill	sawmills
fuji xt 1 camera buy	fuji x t1
telescopic golf iron	telescopic golf
framed tulips embossing folder	tulip embossing folder
what color is hickory tan	what color is hickory
oakley inmate men's accessories	oakley inmate
double ended snaps bulk	double end snaps
trilithic 360dsp repair shop in tulsa ok	trilithic
thesoda fountain com	fountain.com
kitchen island hamilton buy and sell	kitchen+islands
spun lazy susan	lazy+susan
herramientas de baterias de la marca milwaukee	milwaukee
dermacol montreal	dermacol
eze tool snow blower	eze tool snow
chopard madness shower gel	chopard madness
pro hormonal thor importado dos eua	pro hormonal
frigo porte sans debord	frigo
ganzo touch pro ultra	touch pro ultra
how much does a combustion chamber cost	combustion chamber
used stationary bicycle sit down	used stationary bicycles
fw c 4m	fw c
canon t5i rebel eos plus extras for sale $400 edmonton edmonton area buy and sell cameras camcorders	canon t5i
symantec system recovery 2013 r2 serial	system recovery 2013
akumulator 12v20ah nr 144924 usa	12v 20 ah
map of northfield mn	northfield minnesota
vitamix 6500 price	vitamixes
donde puedo comprar swarovski online	swarovski
osp designs 2544	osp designs
dc97 16985a	dc97
see samples of mo hair	mohair
greenway filter gwf3 canada	greenway filter gwf3
ibm 8648 36u server with drive	ibm 8648
crosse tactique sks	cross tactical
kimchi kits mississauga	kimchi kit
mini pizza play set	pizza play set
tivi sam sung j6300	samsung j6300
mikki senkarik art art	mikki senkarik art
http women duluthtrading com store womens womens sale womens clearance womens sale womens clearance aspx	duluth trading com
purchase goldlok train 9447c	goldlok
america sexy vidio	american sexy
starbucks floor backets	floor brackets
livres recettes bon appetit québec acheter et vendre livres	bon appetit
whirlpool cabrio 3.8 top load washer	whirlpool cabrio 3.8
key turners that are longer than 5inches	key turner
2dr1 217fls	2dr1
mccormick tractor dealers	tractors
amazon canada hunter caps	hunter caps
laptop battery store el paso tx	laptop batteries store
danze pull out canadian tire	danze pull out
baggallini wallet women's accessories	baggallini wallet
smoke generator canada	smoke generator
nothing over 9.99 panama city	nothing over 9.99
5 16 wrench for sale	5 16 wrench
barn doors amazon	barns doors
128 fl oz container with pump	containers with pumps
micro perforating machines in eeuu	perforating machines
gravel pit sand &amp gravel pit 29 acres could be converted to quary hunting mississauga peel region toronto gta buy and sell ho	gravel pit
egg beater 3 black	egg beaters 3
the woolie paint kit	woolie paint kit
egg chair montreal	egg chairs
algea x cream	algae x
beer mashtuns calgary	mash tuns
megaboom ue boom paire 2 haut parleur bluetooth longueuil rive sud grand montr u00e9al acheter et vendre ipods mp3 u00e9couteurs	ue boom
the pop up tower from bazuva	pop up tower
how can i get a copy of adobe cs6 premium	cs6 premium
clarinet bag saint louise	clarinet bags
used disc brakes for sale	used disc brake
cheap trash compactors	trash compactors
snowblower cab pembroke renfrew county area	snow blower cabs
welding helmets sale on kajiji	welding helmets
salon de fiesta en dania beach	salones
18 10 thermostat cable toronto gta	18 10 thermostat cable
shure sm7b ontario	shure sm7b
american blower supply warren mi	blower supply
down rigger weights	downrigger weights
cheap apple watch price	apples watch
exc pentax kx white 18 55mm & 55 300mm lenses lots accessories in box	pentax k x
castle ruins in pei for sale	castle ruins
pool cue repair kit	cue repair kit
buy fischer motive 95ti in canadian	fischer motive
dallape accordion for sale	accordion for sale
breyer horses blackish brown with cream colored mane and tail shiny	breyer horse
cordless nailer greater vancouver area buy and sell tools power tools	cordless nailer
akbar khan 2036 70732 27833	khan
green fry	green frying
barn shapes markets	barn shape
cheap window film canada	cheapest window film
welch allyn microtymp 3 portable tympanometric	welch allyn microtymp 3
sapato tampa slip	tampa slip
chromebox cheap	chromebox
turnbuckles grand montréal acheter et vendre	turnbuckles
clarks delsie stella canada	clarks delsie
400131607770 ross sku	ross
galaxy motors british columbia	galaxy motor
kayaks for sale san antonio	kayaks for sale
recycle can crusher	can crusher
buy living vase box in the us	vase boxes
humidifier solenoid parts	humidifier solenoid
chromebook 4gb pc laptops & netbooks	chromebook
sandales huaraches fabrication	sandales huaraches
cheapest canon eos 70d with lens	cheap canon eos 70d
shadowhawk tactical flashlight	tactical flashlights
jnc 600 replacement battery	600 replacement battery
barvac cdt type a	barvac cdt
delsey luggage air spree 25 in expandable spinner upright	delsey luggage
bathroom 30 x 30 medicine cabinets	30 x 30 medicine cabinets
bollinger sliplock	slip lock
husqvarna gcv160 for sale	husqvarna gcv160
back butter buddy canada	back butter buddy
building a rocket stove	rocket stove
focus monthly softcolors manufacturer	focus monthly softcolor
propane counter top griddle owen sound buy and sell home appliances	countertop griddle
watts mixing valve commercial	mixing valves commercial
lynx 5200 ville de québec	lynx 5200
hvlc fans with motors	fan with motor
lampe tiffany québec acheter et vendre maison intérieur	lampes tiffany
grasping forceps flexible price in usd in usa	grasping forcep
usa studex earrings price in philippines	studex earrings price
bauer apx2 stick eberle	bauer apx2 stick
napoleon lex 485 accessory	napoleon lex 485
caristrap vendre	caristrap
kitchen island sherbrooke buy and sell	kitchen+islands
craigslist orlando ipads for sale by owners	ipads for sale
leki ski pole canada	leki ski poles
la forge de la te?te bru?lee com	la forge de
christmas trees holiday lane	christmas trees
ai catalog 60 14659 0001	60 14659 0001
polo red intense 1.0 oz 2.0 oz men	polo red intense
do uniform belts hurt u	uniform belt
used bird cages for sale	birds cages
balaram dhakal georgia usa	balaram
??????? ??????? ???? oregon powersharp ????	oregon powersharp
rameur fitness de lifecore	lifecore
patin bauer 1x	bauer 1x
used t6i for sale	t6i
argon 18 ? ? ? ? ?	argon 18
where to buy olaplex in vancouver	olaplex
amason wr17x2355 clear shell	clear shells
www usa xcxx com	xcxx com
rca cc350 vhs camcorder	camcorder
used chimney on kiji nl	used chimney
antlers vernon	antlers
sound standard la 5200	sound standard
daily's peach mix target	dailys peach mix
samsung galaxy mega 16gb black	samsung galaxy mega 16gb
taxidermiste puy de dôme	taxidermie
quorum shade cigars	quorum shades
kitchen islands with stove top in it	kitchen+islands
used breyer horses amazon	used breyer horses
baby red foxes for sale in arkansas	baby red fox
pearle vision denver	pearle vision
can you buy wunderbrow in stores	wunderbrow in stores
delay pedal vancouver greater vancouver area	delay pedal
mary kay entrige colonge makeup	intrigue cologne
where can i purchase the intelliwhite the cheapest	intelliwhite
cwonder qvc	c wonder
where to buy meter box in san diego	buy meter box
white leather headboard canada	white leather headboards
http j19 videowith me us c6b	c6b
aronia ki photo nangi nangi	aronia
the briscoe county jr orb toys & hobbies	orb toys
building a kitchen island from scratch	kitchen+islands
unlocked 4g lte phablet	phablets
11 7 8 x 18 cooking grid	cooking grids
iphope 6 ontario acheter et vendre	iphone 6
esee junglas best price canada	esee junglas
used paddle boards in maine	used paddle boards
30 inch refrigerator bottom toronto gta	30 inch refrigerator
amway liquid detergent price	liquid detergent prices
thermopile st louis area	thermopile
vanee air exchanger parts	exchangers parts
label m relaxing balm come se usa	label m relaxing balm
rent microsoft office 2013	office 2013
teknmotion 400 dvd wallet	dvd wallet
fresadora milwaukee	milwaukee
garmin nuvi 2505 series price	garmin nuvi 2505 series
sony xperia z4 compact ??????? ????? ? ???	xperia z4
osprey 58 overstock	osprey 58
21 day fix containers lethbridge	21 day fix containers
coe studio discount	coe studios
suntec solenoid suction pump model kr	suntec solenoid
scandinavian heated streets	heated streets
braun 5040s canada	braun 5040s
pouf grand montréal	poufs
power wheelchair rental miami	power wheelchair
cortega second look ii 2758	cortega
termostato said bay sad ge 23	ge 23
scsi cable for axon 1322	scsi cables
stok grills discontinued	stok grill
fissler toronto gta	fissler
www cindylawson tripointehomes com	tri pointe homes
bird eggs mini incubator	mini incubator
viper 7701v remote amazon	viper 7701v remote
mixer controller toronto gta buy and sell electronics	mixer controllers
he 32005376 001	32005376 001
ferrari fxx 2013 price	ferrari fxx
kegerator supplies in kitchener on	kegerator
artificial outdoor urn filler	urn fillers
flashlight sex for men	flashlights
rockn roll kitchen canister sets	canister set
ignition module for nissan pathfinder	ignition module
homecraft rolyan ltd	homecraft rolyan
loupe 40x markham york region toronto gta buy and sell jewellery watches	loupe 40x
best 10 cubic upright freezer	10 cubic upright freezer
dehumidifier cape breton	dehumidifier
ys101826 modulating gas board	modulating gas
sole block k2	sole block
fujistu plasma tvs ontario	fujitsu plasma tvs
i need to order a master cleanse kit	master cleanse kit
dog runs cages & crates	dog runs cage
lil driver walker silver	lil drive walker
jbw women's j6278 setc	jbw
table skirt calgary	table skirt
amerikada zenfone 2 16gb ne kadar	zenfone 2
humminbird helix belleville belleville area	humminbird helix
used tires atv oshawa ontario	used tires atv
gear wr29x5153	wr29x5153
frp	frp
oneida roaster with rack cambridge kitchener area buy and sell home indoor kitchen &amp dining wares	oneida roaster
suoper sonic vacuums robot home & garden	vacuum robots
bug out survival kit	survival kits
valor maquina skin classic em orlando florida	skin classic
copic markers used pens & markers	copic markers
juno t 809 ballast	juno t809
nbr 14608 07 lei 11901 09	lei
video piloxing	piloxing
television laurentides	televisions
bedspread style 6a 102	bedspreads
honeywell high limit aquastat l4080b10 22 2	honeywell high limit
edie rose peacock place setting	edie rose peacock
large scale garden equipment manitoba	large scale garden
compactor kamloops buy and sell home appliances	compactor
heinola easy run long 130mm	heinola
small white aquarium stand	aquariums stands
onepiece kids snowsuit	kids snowsuits
interior door 24 x 72	doors 24 x 72
trail cameras winnipeg	trail cameras
cellier midea hs	midea
knox box	knox box
neolt leonard usa drafting machine	drafting machines
used 66 bath tubs	"66"" bathtubs"
oval shape tubs with center drain	tubs with center drain
precast concrete threshold price	concrete thresholds
cracker barrel canister sets	canister set
mitjelent az enzympeeling kifejezés	enzym peeling
bougie introducer buy online us	bougie introducer
kill it rich piana	rich piana
louis tiffany pendant lights	tiffany pendants lighting
canon t5i halifax buy and sell cameras camcorders	canon t5i
monitor behringer grand montréal	monitors behringer
accesorios carolina herrera 212 vip party icon bangles nyc	herrera 212 vip
barbecue cost in darwin	barbecues
haloterapie in us	in u s
used saddle sale sites	saddle sale
krieghoff chokes for sale	krieghoff chokes
apple laptop price in america 2015	laptops prices in america
????? securite cameras	security cameras
70 watt sodium vapor outdoor light fixture	70 watt sodium
toro ccr 3650 achat	toro ccr 3650
clear plastic in shower towel bar 18 inch	towel bar 18 inch
price pfister a11218	pfister a112 18
stick christmas trees with led tips	christmas trees
artificial christmas trees from hobby lobby	christmas trees
ombre leggings target	ombre leggings
vickerman 48 x 23 frost angel pine 70cl 1011t	vickerman 48
walmart luggage 20 inch carry on	luggage 20 inch carry on
formas de brownie na miame	brownies
hampton bay medium cherry leaf fan blade replacements	leaf fan blades
omaha hot dogs	hot dog
15a 40a challenger	40a challenger
ikea hackers reception counter	reception counters
paris france bread wholesale	french bread wholesale
acer aspire x3200 operating system	operating system
walmart jump ring maker	jump ring makers
where to buy suifan's kwang tze solution	kwang tze solution
tenor singers in nova scotia	tenor singing
poly snow plow blades vs steel blades	snow plows blades
como fabricar un humidor de tabaco	humidors
kimmidoll nobuko	kimmidoll
honey bunny cuddly pals shop	cuddle pal
rug loom loom for sale city of halifax halifax buy and sell hobbies crafts	rug looms
deckmaster brackets	deckmaster brackets
gateway laptop 400sd4 battery replacement	400sd4 battery
kolher tolit tank 1.6 liter	kohler toilet tank 1.6
looking for real life like fresh cut artificial christmas tree that looks so real with pine cones on it	christmas trees
pirate flag 6x4	pirate flags
chanel no 5 eau de parfum prix	no 5 eau de parfum
descent expansions shadow of nerekhall	descent expansions
inspirit bladez elliptical price	bladez ellipticals
whitecloud ring combs	ring comb
www homaxproducts com	homax products.com
oral dispensing syringes 0.5 ml	syringe 0.5ml
coal stove within harrison mi 48625	coal stoves
windows 8 oem software	windows 8 oem
smith corona typewriters new	typewriters new
incubator within saint paul mn	incubators
sea gull highland collection 42251 824	sea gull highlands
magnetic steel pie pan	steel pie pans
samtec ffsd 13 01 n price	samtec
ar 15 5.56 mm supressor	5.56mm suppressor
peignoir sets for women lilac	peignoir sets
visi probita ?? ?	visi probita
mercury thermometer amazon	mercury thermometer
samsung 55 inch tvs electronics	samsung 55
verizon htc desire 612 lte prepaid smartphone	verizon htc
d920 pre wired pickup canada	prewired pickups
bronze rat ornament	rat ornament
glycerin 12 woman size 8	glycerin 12
rane 62 case toronto gta	rane 62 case
toilet seat 10 inch bolt spread	toilet seat 10 inch bolt
low price for bathtub with shower	price for bathtubs
verona cooktop trim kits	cooktop trim kit
ekco 123 skimmer	ekco 123
single pole thermostat wiring diagram	single pole thermostats
chuck it dog toy wheel	chuckit dog toys
draft door covers	drafts door
home depot microban lexington sc	microban
panelli telati canada	panelli telati
site dos estados unidos xbox one	xbox one
ilan nolu tarla nerede konum 57375 359	tarla
market details id com ucmobile intl&referrer utm_source 3dgongyefq 40msales 2523336 26utm_content 3dclickid 3a59d82bd059246bb2b1	u c mobile
maillot de gymnastique québec	gymnastics
1 6 indians figures action figures	indians figurines
old flags and torn	old flag
cheapest place in east peoria illinois area foor tb oil	tb oil
kitchenaid refrigerator front panel	refrigerator front panels
build a snowman pieces in a jar	snowman pieces
2003 g35 control arm ontario	g35 control arm
can am pro armour ontario	pro armour
commercial stack dryers penticton kelowna	commercial stack dryers
grandfather movement rz b6	grandfather movements
honeywell 5301doj amazon	honeywell
cameras fixed in bakersfield california	cameras fixed in
skylanders superchargers goiden high volt for 60.99	superchargers
price of olympia sg 3 sale	olympia sg3
souliers salomon	salomon
ship chainsaw	chainsaws
vision fitness t9700s price	vision fitness t9700s
qual o cinto que usa com chemise	chemise
www goldlok com	goldlok
green scallop paper	scallop paper
uhb645 1000w lg	1000w lg
metal lathe 7 x 12 mini metal lathe new mississauga peel region toronto gta buy and sell business industrial	mini metal lathes
dc47 00019a city of montréal greater montréal	dc47 00019a
thdir dres kyfa 5l9at adfad3 4m	kyfa
samavar mississauga	samovar
kidkraft imaginarium my modern dollhouse city of halifax halifax buy and sell toys games	dollhouse
nordictrack freestride trainer calgary	freestride trainer
18 virgin sdwexc	18 virgin
ladies down vest craigs list	ladies down vest
mobile dimension sawmill price	sawmills
48 refrigerator freezer sizes	48 refrigerator
chaise lounge toronto	chaise lounges
artificial window scenes	window scenes
rocking chair cushions chevron	rocking chair cushion
used dance floor for sale craigslist in dallas	used dance floor
harlem 125 kima braid	harlem 125
aquadis international	aquadis
gas powered shovel	shovel
cogeco converter for sale	converters for sale
surface pro 4 missisauga mississauga peel region toronto gta	surface pro 4
images of a birthday cake	birthday cake
toy barn facebook	toy barns
paw patrol toy canada	paw patrol toys
chan6619 jeunesseglobal com	jeunesse global
www bf com dotkom www bf com bf com	www.bf..com
6x9 notebook refill canada	6 x 9 notebook
soudure acetylene kit de soudure à l acétylène laval rive nord grand montr u00e9al acheter et vendre outils autre	acetylene kit
garrison water cooler parts	water coolers parts
sony ss cn 495 h center speaker	center speakers
dewalt tools dck263	dewalt tool
french olive pasta bowls	olives pasta bowls
fabric length measuring tool	length measuring tools
aquarium bio ville de montréal grand montréal acheter et vendre	aquariums bio
quilts picnic canada	quilts.
quel endroit trouver le curcumine ttc en poudre a ottawa	curcumine
outdoors twilight switch	twilight switch
prix mixette blacksdehker	black decker
hazourdous material forms kamloops	hazardous material forms
karman lt980 wheelchair used	karman lt 980
cheep&amp beautifuul rugs toronto gta	beautiful rugs
infantry watch special forces	infantry watches
bestar bureau informatique legend	bestar
hanging scroll of tigers	hanging scrolls
men's uno usa	mens uno
presse drill lanaudi u00e8re acheter et vendre outils outils u00e9lectriques	press drill
pinecone swag kitchen border	pine cone swags
dryer motor nova scotia buy and sell home appliances washers dryers	dryer motors
fhkmbcw	fhkm
dyson v6 slim price canada	dyson v6
target shelve cover 74 h by 14 w	shelving covers
termostat hose cop for nissan sentra 1994	hose cap
beach body dvd edmonton edmonton area	beachbody
truck ladder racks canada	ladder rack
sata cables for ssd	sata cable for
vertige elite tablet 13.3 inch	tablet 13.3
privacy pop bed tent canada	pop bed tent
crane cow québec acheter et vendre	crane cow
used numberall 40b	numberall
cabinet bed calgary buy and sell furniture	cabinet beds
fireplace mantels shelf moncton buy and sell	fireplace mantels
american standard titan toilet reviews	titan toilets reviews
fixing scratches on stainless steel	scratches on stainless steel
humidor contemporary	humidors
slater 5050 prices	slaters
harley fender fillers toronto gta	harley fender fillers
printable dragonfly story	dragonflies
wwprosonicelectronique	prosonic
marker ampire helmet canada	marker ampire helmet
tecumseh ice auger blades	ice auger blades
homemade fruit fly traps	fruit fly traps
sofsole fireside	sof sole
ps vita estados unidos	playstation vita
pasta machine cambridge kitchener area	pasta machines
sams club christmas trees	christmas trees
kitchen island 60 x 36	kitchen island 60
15sh1 lo218 h30 90 309572 h24v c1 30	309572
which over the head blue tooth is best	over the head bluetooth
skylanders superchargers	superchargers
best buy edmonton	buy edmonton
primary belt drives for harley davidson	belt drives for harleys
blue flower century shape coupe by rosenthal continental	rosenthal continental
replacement ace 7 16 20 tap	7 16 20 tap
128 oz cookie jar	cookie jars.
maine coon for sale bc	maine coon for sale
alta pro 283ct vendre	alta pro 283ct
flora cal products riverside california	flora cal products
le corbusier ontario	corbusier
what is a 48 frame motor	48 frame motors
yamaha dtx 400k buy	yamaha dtx400k
boston acoustic part 304 160007 00	boston acoustic parts
amazon full frame camera sales	full frame camera sale
where to buy grindelia in seattle	grindelia
buy shoe rack online	shoes racks
nikon d7200 us	nikon d7200
doc mcstuffins plastic snowman	doc mcstuffins
pellet stoves nova scotia buy and sell other	pellet stoves.
pair large candleholders	large candle holders
top secret security safe box for kids	security safes boxes
buy chinese fortune sticks	chinese fortune sticks
camcorder dartmouth halifax	camcorder
badgley mischka fischer heel blue	badgley mischka
cascading revenol	cascading
wishing well plans	wishing well
flow box in usa	flow box
hyperbaric within omaha ne	hyperbaric
white l476	l 476
gazebo penguin ontario	gazebo penguin
12x12 shadow box wholesale	12x12 shadow boxes
use tow in delaware	uses tow
rotomartillos bosh usa	bosch
bench made knifes forsale	bench made knifes
roots jacket girls	root jacket
yellow toilet 10 rough in	toilets+10 rough
$75 kneeskin fina approved	fina approved
moneda 35th president usa john f kennedy 1961 1963	kennedy 1961
schirmer tear test strips i dew	schirmer tear test
proteine americane	proteine
pentax kx 12.4 mp digital slr camera w 18 55mm lens	pentax k x
used hunting boots size 8 wide	used hunting boots
moto e case walmart	moto e cases
ecco boston 44	ecco boston
relius solutions wire computer center	relius solutions
refugium calgary	refugiums
2755 22ct milwaukee	milwaukee
48 inch mattress saskatoon buy and sell furniture beds mattresses	48 inches mattress
single size captain bed price	captains bed price
gaming chair ontario canada	gaming chairs
yamaha excel v 540	yamaha excel v
amazon klein tools combos	klein tools combo
0.3 mm mitutoyo stylus	mitutoyo stylus
jayman modus mahogany	modus mahogany
how much is a srg pro wall	pro wall
lame tuuk lightspeed 2 a vendre	tuuk lightspeed 2
7.23 of 15.23 is	7.23
stainless steel fireplace doors	fireplaces doors
split v neck caftan	caftans.
best deals on lg black stainless in palm desert	lg black stainless
super dmz 3.0	dmz 3.0
dryer fabric softener bar	fabric softener bar
powerfist 28 framing nailer	28 framing nailer
5045 black developer assy	developer assembly
kids electric scooter québec	electric scooter
through wall listening device	listening device
after market flame switch	flame switches
where can i buy wire dolly in greeley	wire dolly
12x24 calendar refill	calendar refill
clutch 12v	clutches
mag400 odg	mag400
vacuum wand parts	vacuum wand parts
double pellet stove	pellet stove
flavor grid 24 b 05	flavor grid
chek antenna immobilizer	immobilizer
wagon wheel light ottawa ottawa gatineau area	wagon wheel light
www california rice comywords grasshopper grasshopper	california rice
where to buy table covers in scarborough ontario	tables covers
ward signature hi watt heater vwn42318	high watt heater
intel computer stick oshawa durham region toronto gta	intel computer stick
polo ralph lauren mens shoes usa	men shoes usa
ebony biggest	ebony big
guardian gear stroller	guardian gear
memoire 44 air pack occasion	44 air pack
earnest eats cereal on sale	earnest eats
marquis de brim cognac	cognac
inexpensive terz guitar	terz guitar
mrp f600 alpine amp	alpine amp
galaxy note under 200	galaxy note
logitech ue boom québec	logitech ue boom
185 55 15 été grand montréal autos et véhicules pièces auto pneus pneus jantes	185 55 15
1 2 hp stainless steel jet pump regina	stainless steel jet pump
1910 compact mirror	compact mirrors
america's nard drum solos dove comprarlo roma	n a r d drum
mehmet saraç o?lu strepto koka bakterinas?l il	streptococcus
luichiny boots amanda	luichiny boots
arte indigena americana	arte indigena
ps4 conductive film	conductive films
2011 toyota rav4 inmobilizer module	immobilizer
chap ice revo canada	chap ice revo
25 off brand new dewalt power tools etc still in pkg oshawa durham region toronto gta buy and sell tools power tools	dewalt powertools
multiport pool valve top mount 1 hp	multiport pool valves
r22 honeywell usa price	honeywell usa
nutone ws330ssc filter bps3fa30	bps3fa30
valeroso 6200 rs en unión city new jersey	6200 rs
used vexilar fishfinders	used vexilar
reborn baby girls with tons of hair for $20	reborn baby girl
escada 87965377	escada
luxury luxe pillow 045121	luxury luxe pillows
yamaha mox f8 piano keyboard toronto gta buy and sell musical instruments pianos keyboards	yamaha moxf8
humiders for home	humidors
nolan n44 prix	nolan n44
lg oled 55 price	lg oled 55
pegasus asme a11218 1 2000	a11218.1
3000ml ?? ?	3000ml
lesco spindle assembly	lesco spindle
16 gauge hypodermic needles	gauge hypodermic needles
polyresin intimate last tango dancing couple lover anniversary figurines	anniversary figurines
staples canada matsunichi	matsunichi
all sun oxi cleaner	sun oxi
dollhouse radio home dã cor	dollhouse
barkwise canada	barkwise
kelly rae roberts dear world mugs	kelly rae roberts
nutri extractors for sale for 24.00 dollars	nutrition extractors
74 or 75 inch shower curtain	75 inches shower curtain
tb12 gear	tb12
kids bookcase mississauga peel region toronto gta buy and sell furniture bookcases shelving units	kids bookcases
meat slicer 12 edmonton edmonton area	"meat slicer 12"""
grex stabilizer	grex
20 under counter freezer drawers	20 under counter freezer
mirror tray winnipeg buy and sell	mirrored trays
télécharger windows 10 en version finale	window 10
scie à céramique rubi dt 250 evolution ville de qu u00e9bec acheter et vendre outils outils u00e9lectriques	rubi dt 250
how much are black kingston boota	kensington boots
s?ck np 1150 nc w2s endüktif kapasitif	np 1150
tiendas que venden hot toys usa	hot toys
???????? ??????? ? ??? yield photos	yield photo
apple watch sport 42mm	apples watch
proenza schouler ps11 classic linosa us	proenza schouler
la teinte sayoss violet pour cheuveux	syoss
acheter acerola vitamine c naturelle	acerola vitamine c
teacher discount microsoft office 2013	office 2013
blizzard brahma longueuil rive sud grand montréal	blizzard brahma
kitchen island winnipeg	kitchen+islands
flamin hot funyuns bulk	flamin hot funyuns
aquarium aquarium 50 gallons sans le meuble ville de montr u00e9al grand montr u00e9al animaux accessoires	aquarium 50 gallon
sylvania cool wh bulb 22w	bulb 22w
flow m9 bindings large	flow m9 binding
ao smith burner assembly kits san diego	ao smith burner assembly
machine a sluch québec acheter et vendre commerciaux industriels	machine a slush
wallpaper store halifax	wallpapers stores
rideau pour fenetre demi lune	demi lune
ionlite purifier new	purifier
shr1505r ca	shr1505r
circulator pump belleville belleville area	circulator pump
kristal giga cut36 tilecutter	36 tile cutter
copic markers pens & markers	copic markers
randy rhoads knuckle bonz figures	knucklebonz figurines
furminator brosse chien montréal	furminators
retro 11 low bred nwt	retro 11 low
gt i826 samsung motherboard phone stamps	samsung motherboards
pig rotisserie toronto gta	pigs rotisserie
vente laveuse secheuse frontale blomberg	blomberg
propane generator toronto	propane generator
omega nc800hds canada	omega nc800hds
beachbody hammer & chisel	beachbody
dc97 18094b	dc97
perigaum 1972 automatic limited p 1001 ipr	perigaum 1972 automatic
wmf mesh skimmer	mesh skimmers
size 10 red head insulated chest waders wholesale	chest waders wholesale
pjponline dust wand	dusting wand
where to buy portion container	portion containers
succulents ontario	succulente
custom exotic thigh high boots	exotic thigh high boots
75024 75004 lego nun fiyat? n?n 2 sinin toplam?	75004
cartridge ceramic latoscana 73cr690thex	cartridge ceramic
www michellobamadolls	michell obama dolls
used work tables tools	used work table
monarch desks city of toronto toronto gta buy and sell furniture dressers wardrobes	monarch desks
us travel bag	travels bags
moen faceplate too small	moen faceplate
cheap fold over combat boots size 11	fold over combat boot
quad moto pieces bellechasse	quad motorcycle
under armour clutchfit prodigy aqua black 8.5	ua clutchfit
ql2 lower hook assembly e143	ql2
sawmills moncton	sawmills
flammable vapor ignition resistant	flammable vapor ignition
carpenter company peaceful dreams	peaceful dreams
saitek sherbrooke	saitek
ganging clamps chairs	ganging clamps
amazon dashcams	dash cams
princess bed nova scotia	princess+bed
steren mexico df	steren
who sells 12 mm allen socket in ga	12mm allen socket
car port canopy 18x20	canopies 18 x 20
adjustable height sullivan sewing table 38431	sewing tables
tabouret dazzer	dazzer
sizzix bigz alphabet dies	sizzix bigz alphabet
b&o earset 1 home	earset 1
meilleure lavabo et vanité	vanity
pleasant hearth 1750 sq ft pellet stove 35000 btus with 40 lb hopper ph35ps	pellet stove
morfurniture com salem oregon	mor furniture com
air fit f10	airfit f10
buy out of date syringe for sale	syringe for sale
irwin tools strait line 64499	irwin tools strait line
mixer 12 canali americano di qualita	mixer 12
zalwaan axlaamum	zalman
rockwater designs all weather suit	all weather suits
costco barn doors	barns doors
wallpaper stores in mississauga	wallpapers stores
nikon cameras coolpix s4000 value	nikon cameras
trek ascent insulated	ascent insulated
dixie utensils reusable	dixie utensils
hevc box instructions	boxes instructions
used gazebo yard garden & outdoor living	used gazebo
?? war mark ?? ?? ??	war mark
electric humidifier steam	humidifiers steam
nanofil s11e05	nanofil
spectrum surfboards for sale	spectrum surfboards
peaceful passages by janet wehr	peaceful passage
emoji sweater mississauga peel region toronto gta	emoji sweaters
52025 60050	52025
what is a vw cc r line	what is a volkswagen cc
michael kors silver sandals wedge	silver sandals wedges
505055 wrs 5 in canada	wrs 5
magnacolorart com	magna color art
apartment washer north bay buy and sell home appliances	apartments washers
used welders in temple texas	used welders
peanuts gang	peanuts gang
kijjizero turn mowers edmonton edmonton area	turn mowers
where can i buy a pco air purifier	pco air purifier
e4 merrychef montreal	merrychef
twisted table design	twist tables
second hand kayaks for sale	kayak
djibril beye	beye
oakley xxl control	oakley xxl
epoch shampoo and light conditioner	epoch shampoo
key of windows 8.1 pro	windows 8.1 pro
calico critters québec	calico+critters
captain bed ikea	captain beds
cleveland westside	westside
electric motor for vac	motor for vac
yuengling porter availability in sc	yuengling porter
stewart warner industrial balancer model 2000	industrial balancer
kayaks for sale vancouver island	kayaks for sale
honey dripper claris	honey dripper
bernz omatic turbo	bernz omatic
clive christian lotion women	clive christian
tasteless sleeping drops	sleep drops
snowboard dress	snowboard
fire chaplains ontario	fire chaplain
iphone 5c 32gb canada	iphone 5c 32gb
little people nativity set $21	nativity
paulk workbench	workbenches
09962798 cube bookcase	cube bookcases
where to buy kerosene in gainesville ga	kerosene
kerosene within albemarle nc	kerosene
8 camcorder	camcorder
dickey incubators	incubators
jakie wlasciwosci sa cafe latte organo gold	cafe latte organo
p3 cruiser mobility scooter	mobility scooter
ukulele ouest de l île grand montréal	ukuleles
land andr kerne ki pitchere	pitchere
sunbeam cozy spot black	sunbeam cozy spot
conter lee sin	counter lee
tablets mercado libre eeuu	tablets
charlotte nc used lacrosse rebounder	used lacrosse rebounder
californ	californ
kawaii crush pb and j sale	kawaii crush
cost of ozone therapy equipment on canada or usa	ozone
portable front load cd player	front loading cd players
rs pb spray	pb spray
9 circline fluorescent bulbs	9 circline fluorescent
dexona tablets for weight gain	tablets for weight gain
cymbals kingston kingston area buy and sell	cymbal
ja1m193ns 1	ja1m193ns
cheap 10 x 20 tarp	10 x 20 tarps
basic equipment xl work	equipment xl
hasbro star wars wholesale	star wars wholesale
60 inch barn door	barns doors
sog knife markham york region toronto gta buy and sell electronics	s o g knives
barn doors under 250	barns doors
ls pab60 18.5 v 3.5 a	18.5v 3.5
tree farms that sell noble fir trees	noble fir trees
75 off iphones	iphones
nordictrack c700 ?? ??	nordictrack c 700
xd xl 10025 x1	xd xl
bead board sliding barn door	barns doors
1854	1854
cigapuri www hsx dodcom	hsx
mac nut oil prices	macadamia nut oil
torqmotor me210103aack	torq motor
roku 3 best price	roku3
mfc j430w price in canada	mfc j430w price
2016 kawasaki teryx accessories	kawasaki teryx accessories
cd sleeves wholesale in toronto	cd sleeves wholesale
best price on new fully loaded saiga	new fully loaded
maquina de overlock usada	overlock
humidor 150 count	humidors
big bag of science at cvs pharmacy	big bag of science
chef's companion gravy	chef companion
batman gotham city ps3	batman gotham city
iphone 4 iphone 4 16go opérateur télus laval rive nord grand montr u00e9al acheter et vendre t u00e9l u00e9phones t u00e9l u00	iphone 4.
pharmassure inc	pharmassure
what kind of 10 rough_in toilet do niagara compene have	"10"" rough in toilet"
refurbished hospital beds canada ontario	refurbished hospital beds
canon 1d x toronto gta	canon 1 d x
two wheel walker winnipeg buy and sell health special needs	two wheel walkers
kayak for sale va	kayaks for sale
pgi 250xl bk walmart	pgi 250 xl
gtx 970 usa	gtx 970
sonia rykiel enfant sale	sonia rykiel
kegerator beer fridge	kegerator
hgfdwizxsdc0yiho5 grdtrdysdtcfklgñjp yhfrrfgy4rv nb cf7	cf7
xbox one elite estados unidos	xbox one
apple watch space grey cheap	apples watch
gas fireplace insert low prices	gas fireplaces
usa m51 fishtail parka	m51 fishtail parka
boflex toronto gta	bowflex
shoe cabinets 28 wide	shoes cabinets
joie microwave chip maker instructions	joie microwave chip maker
sandale oakley homme	sandales oakley
earsonics sm64 price	earsonic
nutridrink usa	nutri drink
homemade oatmega bar	oatmega bars
pedicure chairs alberta	pedicure chairs
color contacts ft myers craigslist	colored contact
kijijihalifaxtablesaws	table saws
lea gabrielle height	gabrielle height
bombilla jcdr 120v 3w	jcdr 120v
new york calendar 2016	calendar 2016
oticon hearing aid prices	hearing aid
48x32 shower kit	48x32 showers
breedlove guitar price list	breedlove guitars price
nad discount	nad
toto washlet s300 parts list	toto washlet s300 parts
half barrels for garden duncan bc	barrels for garden
anti reflection filter in 532 nm by ion beam assisted deposition effect on mgf2 nanostructure thesis pdf	anti reflection filter
value in action points	values in action
bird cages cheap	bird cages
reproduction carnival glass canister sets	canister set
rusk curl freak	rusk curl
venta de paramotor en estados unidos	paramotor
kohler k 7258 rp industrial exposed shower rough plate	exposed showers
origami cart hsn	origami carts
incubator within anaheim ca	incubators
craigslist vancouver peacock male wanted	peacocks male
otter xt1200 lodge	otter xt 1200
lta320wt l06	l06
silver christmas tree amazon	silver christmas trees
us polo assn jacket price bells	u s polo assn jacket
hp envy17 notebook pc computers tablets & networking	hp envy17
miller diesel welders for sale	welders for sale
telescope greater vancouver area buy and sell hobbies crafts	telescopes
pink mudbrook double bend paddle for sale	double bend paddle
zone selector switch in gta	zone selector switch
lowepro pro runner 350aw ontario	lowepro pro runner 350
green power juicer canada	greenpower juicer
panasonic sd yd250 automatic bread maker with yeast dispenser white	panasonic sd yd250
power presenter on sale in rexdale	power presenter
fornecedor de relogios invictas dos eua	invicta
television tucson	televisions
amazon com copper mug currently unavailable	copper mugs
hobart bain marie	bain marie
micrometer victoria	micrometer
wire guard fluorescent lights 48 x 12	wire guard fluorescent
size 14 kasper dresses	kasper dress
tradmill calgary	treadmill
crayola twistables colored pencils 30	crayola twistable
emty boxes brass ho scale	boxes brass
maytag bravo washer parts in toronto on	maytag bravo washers
sw3876 switches controls	switch controllers
brothers sewing machine co within jacksonville fl	brother sewing machine
6 ring binders 5.5 x4 5	ring binder 5.5
autotrol logix 740	logix 740
gn9350e wireless toronto gta	gn9350e
fellowship of the peacock	of the peacocks
moen conversion kit 6000 23	moen conversion kit
pneus usados 275 40 17 á venda em portugal	275 40 17
pvc water stops us east coast	pvc water stops
ou on achete gameband minecraft quebecois	gameband minecraft
ice packs for migraine headaches	ice packs for migraines
craigslist used pellet stoves for sale	pellet stove
manhasset music chair	musicians chair
usa vwu	vwu
xylophone musser m31	xylophone musser
dakine jersey cyprès	dakine jersey
torque technologies t1 tuner	torque technologies
old brita filter replacements	old brita filters
www home depot ice caddy com	ice caddies
baton de ski elan amphibio white	skis elan amphibio
canarm speed control for 2 ceiling fans	canarm speed control
iphone 5s nas lojas dos eua	iphone 5s
greens harvester for sale canada	greens harvester
miniature dollhouse items	dollhouse
ridgid 13 inch thickness planer em1502 35482	ridgid 13
jordan 1 black and red for sale	jordan 1 black and red
ms office 2010 3pc	office 2010 3 pc
star wars luke skywalker bespin jacket size medium	jacket size medium
tea cups and saucers bulk seconds	tea cups and saucers
hitachi c7st	hitachi
madden 16 ps3 lévis chaudière appalaches	madden 16 ps3
wire piercing probe radio shack	piercing probes
aquelle marine therapy system laca on	aquelle marine therapy
thule cargo box comox valley area buy and sell sporting goods exercise	thule cargo boxes
stimpson scale value	scales
used eye shadow kijiji montreal	eyes shadows
maple syrup stainless steel evaporator steam hood	steam hoods
asus 0268 50162 08386 aaoem	asus
14k gold lobster clasp 10 x 4 mm clasps & hooks	14k gold lobster clasp
betts cigar floats	betts
my ride behind a fast recumbent bike youtube	fast recumbent bikes
prices for adjustable steam vents	adjustable steam vent
used cupcake stands for sale	used cupcake stand
satco par 38 indoor outdoor bulb	satco par38
how much do baby pigs cost	baby pigs cost
diy windows gta	d i y windows
60 inch round table ontario	60 inch round table
lotus doll 01g 180 reg no 20r5268	lotus dolls
maquinas de cocer overlock	overlock
edible cake image dork diary	edible cake images
graffiti guard installers boise idaho	graffiti guard
hd supply bathtub in raleigh	bathtubs.
bed & bath bedding duvet covers orange	duvet covers orange
used special edition fluevogs for sale	fluevog for sale
1974 elephant	elephant.
dictaphone grand montréal acheter et vendre	dictaphone
bulldog doorstop glass	bulldog door stop
prices of dogs in us	prices of dog
tio2	tio2
deeluxe spark xv clearance	deeluxe spark
justformen com insider to sign up	just for men.com
used concrete trowel machines	used concrete trowels
www duluthtrading com whatsis	duluth trading com
a&amp e cage co economy play top cage	play top cages
cheap incubator	incubators
hexagonal glass jars grand montréal	hexagonal glass jars
optical lens groover e bay ca	lens groover
830604 56929	56929
hip vacuum cleaner toronto	hip vacuum
sealed rechargeable lead acid battery 6v 6.0 ah	6v 6.0ah
cheapest cabbage patch kid in canada	cabbage patch kids
vertical track line rh20 8	vertical track
protegez vous maytag mbf2258dem	maytag mbf2258dem
tv 4k vendre	television 4 k
side track saw table london	track saws
search for microsoft upgrades	microsoft upgrades
prestige burner price	prestige burners
ryobip115	ryobi p115
license key stronghold crusader ii 17856 txt	stronghold crusader
fredericton buy and sell tvs video	sale+tvs
blue film kanada	blue +film
esperanto tequila extra anejo	esperanto
beretta 950 22 short threaded barrels for sale	threaded barrels
light blue casserole dish with floral bottom	blue casserole dish
princess beds toronto gta	princess+bed
sears daybed bedding sets	daybed bedding
sirrea lanterns	lanterns
white supra skytop 2 for sale	supra skytops 2 for sale
crystal obelisk glass	crystal obelisks
neon flex rgb	flexible rgb
products from inventor joy mangano	joy mangano
piston stroker telescopic lover	pistons stroker
heavy duty models 50 micron	50 micron
standard us knee size chart	knee sizes
air optix canada	air optix
doll house barrie	dollhouse
battery 10v toys & hobbies	battery 10v
old farm house fixtures	farmhouse fixtures
round ottoman edmonton edmonton area	round ottomans
piano wire tube	wire tubes
windows 10 pro pricing	window 10
masajevde puvis	puvis
sara j 3 sj gmail com	sara j
como instalar as multi combo 95	as multi combo 95
gtx 750 ti 2gb ottawa	gtx 750 ti
purchase visual studio 2010	visual studio 2010
amazon juliet cotton bra	cotton bra
confederate supply wagon and crew model	supply wagons
cnet com 4 k tv rating	4k tv ratings
avian sun bulb guelph	avian sun bulb
chitalas cichlide americain	cichlide
hagit israeli cultured pearl ring 451 976	cultured pearls rings
tablas de snowboard nikita used winter sports	snowboard nikita
partner with us	partnership with
vente telescope pour carabine saguenay lac st jean	telescopes
presenter rf ct 03	presenter rf
vans rowley pro lite usa	vans rowley pro
hps retro white 400w ceramic metal halide quebec	400w ceramic metal halide
triple liniment	liniment
motor reduction motor 250 w	reduction motor
amazon bedspread sets	bedspread sets
centurylink caller id rates	caller id
usautomatic sentry 300 s replacement battery	usautomatic sentry 300s
nikon d7200 kit excelente estado azcapotzalco	nikon d7200
elephant lamps for sale in the usa	elephants lamps
gold lamp shades for sale	gold lampshades
marshalltown sharpshooter 1 saw 6105882 usa	marshalltown sharpshooter
bath tub caddies ottawa gatineau area	bathtub caddies
contact us	contacts
oppo sale 2015	oppo sale
ezem effervescent granules	effervescent granules
cooper feeder ports	feeder ports
118844 s 25 t7 ba100	118844
peinture en poudre	en poudre
jones machine used	jones machine
dehumidifier	dehumidifier
henry technologies fb 695	henry tech
danica les olives pasta bowls	olives pasta bowls
amazon choicemmed	choicemmed
craigslist in surrey used pedicure chairs	pedicure chairs
trespass edgewater mens 3 in 1 jacket	mens 3in1 jackets
white corner fireplace manual women's clothing	white corner fireplaces
direccion de doterra en estados unidos	doterra
clam denali 2 on craigslist	clam denali 2
akai dj kontes singapura	akai dj
find new carhart sleeping bags fore sale	sleeping bags
locknut spanner p n 07916 9580200	lock nut spanner
oneida studios lighthouses	lighthouses
tecumseh snowblower yard machine 8 hp wheel 4.10 6nhs	wheel 4.10
camo balaclavas canada	camo balaclava
electric nail clipper for dogs greater montréal	nail clippers for dog
evergreen outdoor niches	outdoor niche
coated pop up wire	pop up wire
http dfw coolrom com dl 41834 3jv8tz8r w4dyqbxz9otcq 1452771579	cool rom
bear traps for sale	bear trap
hammermill copy paper 11 x 14	copy paper 11 x 14
snow shoes norfolk county	snowshoes
nikon d4s ????	nikon d4s
snimu komnatu v brooklyn ave u	ave u
grote 61391 canada	grote 61391
no 1 soft lead color pencils	soft lead colored pencils
ãtt schaublorenz 75 tuner	schaub lorenz
table tournante thorens	thorens
electric bike canada prices	electric bikes
precio en eeuu iphone 5s	iphone 5s
hitachi multi tool amazon	hitachi multi tool
sg100 16 na canada	sg100 16
crystal metalworks in delaware	crystal metalworks
wooden extendable dinning toronto gta	wooden extendable dining
angry birds store place	angry birds stores
boss br 80 micro digital recorder still in box winnipeg buy and sell musical instruments pro audio recording equip	boss br 80
canon camera 700d price in usa	canon cameras 700d
nobis 9 charger	nobis
pigeon supplies animals	pigeon supplies
where can you find discontinued wall ovens	discontinued wall ovens
where to buy qusome	qusome
vr one zeiss usa buy	zeiss usa
industrial barn door track	barns doors
merrychef psa1108	merrychef
martha stewart beehive cake mold	beehive cake mold
xbee iorelay boards	io relay board
used hoyer stand lifts	hoyer stand lifts
jet spray focus 2009 americano	jet sprayer
right sink vanity top 43 in	vanity top 43
smoker edmonton edmonton area	smokers
pottery barn cookie jars	cookie jars.
www pickgoodshoes	pick good shoes
14k inlay flush stone zuni	.14k
ellipticals elliptical ottawa ottawa gatineau area buy and sell sporting goods exercise exercise equipment	ellipticals elliptical
nigari acheter	nigari
6 christmas trees best prices	christmas trees
www gobli	gobli
control board w10189966	w10189966
alpha level machines	level machine
snow shoes snow shoe package super deal limited numbers annapolis valley buy and sell sporting goods exercise other	snowshoes
dr grandel azulene cream 200ml	dr grandel azulene cream
2054 organ needle	organ needle
cables for ape hangers for a motorcycle	cables for ape hangers
crestron cp3 gv	crestron cp3
tractor supply garage in a box	garages in a box
beverage gravity dispenser	gravity dispenser
skechers mega blade canada	skechers mega blade
montre aco quartz	aco quartz
clone welding helmet	welding helmets
mesh vino sign for sale	vino signs
www dillards com prom dresses	prom dresses
olympus vf 4 toronto gta buy and sell cameras camcorders	olympus vf 4
mn ll jeahsbnuncm l	mn ll
k2 spray for sale	k 2 spray
liebherr 954 mit eine schere	liebherr.
national geagraphic weather station parts	weather stations parts
sawmill within bangor me	sawmills
ridgeview clubhouse deluxe	ridgeview clubhouse
how much does banda ms charge	banda ms
bai tap thuc hanh microsoft project 2010	microsoft project 2010
hz 680m lt m 12 price	680m
pontiac pursuit 2005 cabin air filter	2005 cabin air filter
threshold 002 05 0097	threshold
popcorn in forno	popcorn
wondercore walmart	wonder core
used novelty freezers	novelty freezer
arcoroc france green	arcoroc
thermablaster re500fs	thermablaster
airmusic strap for saxophone thomann	strap for saxophone
west bend 8499	west bend
bauer nexus 800 gloves sale	bauer nexus 800 gloves
motorola xpr 7580 price	motorola xpr 7580
amerika forno	forno
what are the function of lafayette instrument	lafayette instrument
where to buy wow root cover up in blaine washington	wow root cover up
lithio display pole	display poles
role of an advocate	an advocate
tractor power steering conversion kits	steering conversion kits
gate hold open device	gate hold open
rv 32 x 32 shower tub combo	32 x 32 shower tub
sterilite 45 gallon wheeled	sterilite 45 gal
where can you get a weather channel hat	weather channel hats
amazon rubber dolls and prices	rubber dolls
eyes cover advanto llc	eye cover
home made propane fire table	fire tables
callaway x hot set for sale	callaway x hot set
where to buy ecodrink tucson az	where to buy ecodrink
where to buy old mercury thermostats	old mercury thermostats
ancona ducks for sale	ducklings
puma goalkeeper gloves fingersave	puma goalkeeper glove
rechargeable heater amazon	rechargeable heaters
kerosene in new caney tx	kerosene
universal tv base toronto gta	universal tv bases
used marzocchi forks for sale	marzocchi forks for sale
cabinet beds vancouver island	cabinet beds
pickling crocks with blue tornado	pickling crocks
pruba zlota 14k 901	.14k
spectroline bib kit	spectrolines
32 gig memory for stealth cam	stealth cam
win 7 software software	wins 7 software
snowman carrot nose template	snowman carrots
ion generator fap04 filter replacement	fap04 filter
ax098 s	/s
t nailer lowes	t nailer
nikon d4 ontario buy and sell	nikon d4
mystik 15w50 200 lts	mystik 15w50
swanson aluminum metric speed square	metric speed square
true ps800 discount sale	true ps800
tf lg 328g	tf lg
sanicare handheld bidet reviews	handheld bidets reviews
daybeds huge sale _ kids quality furniture_bunk &amp loft day beds mississauga peel region toronto gta buy and sell furniture be	daybeds
genacol price usa	genacol
robinet aquadis	aquadis
dollies barrie	dolly
lh jpg mizuno	mizuno
andrew hewitt scarborough ontario	andrew hewitt
m4 adapter ps4	adapter ps4
polar lights jupiter 2 lighting kit	jupiter 2 lighting kit
kiyaks for sale in grand falls nb	kayaks for sale
tv antenna saguenay lac saint jean autos et véhicules vr caravanes remorques	tv antenna
looking for older colors of zoom dead ringer worms	zoom dead ringer worms
unique wine bottle collector st catharines buy and sell	unique wine bottle
staedtler marsmatic 700 pen	staedtler mars matic
mule cascading inverted antler chandelier	antler chandeliers
www zerorh com	zero rh
produits post mastectomie	mastectomie
hdm z1 prices	hdm z1
fruit bag food & beverages	fruits bag
powerbilt golf gsx hybrid utility rescue club 4h23 graphite uniflex shaft righthanded	powerbilt golf
wire metal trees	metals tree
partner with us	partner with
john bain sutherland scottish nationality room	scotland nationality
12 x 90 black polka dot runner	polka dot runners
kayaks for sale by owner in jacksonville	kayaks for sale
used tires 255 70 22.5	tire 255 70 22.5
indoor plancha grill	plancha grill
where to purchase an easel tv stand in ontario canada	tv stands in
curved shaped bar	shaped bars
one way screens naples florida	one way screens
omnindual saw	dual saw
track ladder rack toronto gta	ladder rack
hvac tool auctions	hvac tools
infrared bed benefits	infrared bed
lopol 12.5 melamine turner	melamine turner
projection tv toronto gta buy and sell electronics	projector tv
mary maxim sweater liners	sweater liners
96 acura slx chassis frame assy	chassis frame
godinger dublin 3 tier bowl server	3 tiered bowls
buy contour next lancet	contour next lancet
nat nast havana cloth size l niagra blue	nat nast havana cloth
cabela's pinnacle shooting bench	shooting benches
dreamlink hd dreamlink t5 hd fta receiver with hd module laval north shore greater montr u00e9al buy and sell electronics	hd fta receiver
versatainer containers 150	versatainer containers
pearl grinder caddy	grinder caddy
supreme total one se grip sr ? ???????	supreme totalone
4k tv for under 500	4k tv
juno line voltage gimbal trim	juno line voltage
lowes com champion toilet	champion toilets
white rodgers hft2700 humidifier	white rodgers hft2700
je chercxhe une soudeuse lincoln twecco invertec v 275 sa baillete	invertec v275 s
golden orb weaver for sale	golden orb weaver
rent microsoft office 2013	ms office 2013
minnetonka 38	minnetonka
chaise home studio	chaise home
bucilla mary engelbreit mother goose lap quilt stamped cross stitch 45 inches by 45 inches	bucilla mary engelbreit
psp 1000 w ac& battle used s n pp 105987718	psp 1000
paraffine ville de montréal grand montréal services santé beauté	paraffine
singer sewing tables for sale	sewing tables
ladders alberta	ladder
e237774 c25	c25
urn fillers and topiary	urn fillers
http su6 withmechat us lxc	su6
pneus de vtt interco reptile a 35 de rabais ensemble de 4 québec autos et véhicules vtts motoneiges pièces vtt remorques et a	interco reptile
million d2105 price	d2105
used splitting axe greater montréal	splitting axe
beam headers ottawa stores	beam header
woodland sawmill for sale	sawmills
standard e lume 63605	e lume
lenox fireplace logs	fireplace logs
target christmas tree on sale	christmas trees
wine barrel sink on pinterest	barrel sink
regista 14 shorts in stock usa	regista 14 shorts
hookless shower curtains in canada	hookless+shower+curtain
samsung range parts canada	samsung range parts
us blanco	blanco
1 6 wood dollhouse kit	wood dollhouse
avanti 24 gas range multiple colors	24 gas ranges
tennis equipment supplies las vegas nv	tennis equipment supplies
classic boralies back pack	borealis backpack
poele lr électronique	l r electronics
turbo roaster infuser	turbo roaster
vaio vpcse price	vpcse
windows 8.1 pro pack canada	windows 8.1 pro pack
best buy lg oled tv	lg oled tvs
rossi ranch hand price canada	rossi ranch
beachbody base shake	beachbody
convert snow blower controls	snowblower controls
electronics shop camcorders by type	camcorder
lil penny posite size 13	lil penny posite
white silicone rubber stoppers	silicone rubber stoppers
synphonat genacol	genacol
what canaries cross to get yellow mosaic	yellow mosaics
wedding fountain punch bowl	fountain+punch
artist b mitchell farm windowpane 25x25 rustic arizona cabin wheel	artist b mitchell
casquette unis	casquette
humidor plans pdf	humidors
master replicas star wars anakin skywalker force fx lightsaber 2002 collectibles science fiction & horror star wars products non	force fx light saber
curver style	curver
card sales international	cards sale
brixton flannels for sale amazon	brixton flannel
fireplace doors wayfair	fireplaces doors
apple watch fredericton buy and sell	apples watch
amazon chop knife	chop knife
sprocket walk xc 120	sprocket
bbq cocktail station	cocktail stations
pesquisar motor ford wi	motors ford
ferro aldo mfa 19266	ferro aldo
hp 10bii st catharines	hp 10bii
acco sigonfile	acco
ninja mega kitchen system 1500 price comparison	mega kitchen system 1500
used water slide fiberglass	used water slides
moose racing carb kit	moose racing carb
stiletto titanium 14 hammer prices	stiletto titanium 14 hammer
apple watch charging cable	apples watch
trouver un buzzer à montréal grand montréal	buzzers
chef buddy brand	chef buddy
nike af1 07 low suede amerika	nike af1 07
skilsaw hd5510 for sale	skilsaw hd5510
4 wall teepee instructions	teepee instructions
courroie gates k060806	gates k060806
duvet covers wayfair	duvets covers
fiat ducati turn signal column	ducati turn signals
replacement parts for campbell plate clamp 6421001	campbell plate clamps
over the counter vitimins for resporoty infrction	vitamins for respiratory
sandton designs inc	sandton designs
best chicken egg incubator	incubators
para que se utiliza el prensatelawirehemmerfoot double fold high snank 490360	snank
yakima control tower london buy and sell sporting goods exercise	yakima control towers
humidor cigar humidor city of montr u00e9al greater montr u00e9al buy and sell other	humidors
slim 110v male plug	110v male plug
mattel flying aces value no 9375	mattel flying aces
lisette l pantalon prix	lisette l
rolands snare drum mississauga peel region toronto gta	roland snare drum
07 tundra bed 5.5 ft	5.5ft
bey berk carbon fiber 25 cigar humidor men	humidors
item 028w005048553001p model 463436813	463436813
used lumex beds	lumex beds
moduleo spirit flooring	moduleo
collet c5 grand montréal	collet c5
testo 0600 9542	testo
jakel inc j238 138 1393	jakel inc j238 138
bluetooth dac review	bluetooth dac
kathy ireland mount view cornertable sale	kathy ireland mount view
ms255sr where to buy	ms255sr
result checker	checker
diy table pedestals	table pedestals
smash 7 cheap	smash 7
julesenchantinggifts com stained glass music	stained+glass
blancoculina mini	blanco culina
bypassing barn door kits	bypass barn door
rvhk phl hgst	hgst
samsung nx1 ontario	samsung nx 1
collecta brahman	collecta
peshtemal canada	peshtemal
iphone 5 lcd ottawa gatineau area cars &amp vehicles cars &amp trucks	iphone 5 lcd
mounted oxpeckers	oxpeckers
harmony slidetrax base plate brass fitting	harmony slidetrax
standing moose toilet	moose toilet
snowboard 100cm grand montréal	snowboard 100 cm
amazon tea cups and saucers	tea cups and saucers
multi pricing levels for bigcommerce	multiple price levels
amerika photo wallpaper	photo wallpaper
