QUERY_COEC	QUERY_COEC
IDF_FRAC	IDF_FRAC
IDF_MISS_LEFT_WEIGHT	IDF_MISS_LEFT_WEIGHT
IDF_MISS_RIGHT_WEIGHT	IDF_MISS_RIGHT_WEIGHT
TP_FRAC	TP_FRAC
QLAS_P_ORGANIZATION_EXACT	QLAS_P_ORGANIZATION_EXACT
QLAS_P_ORGANIZATION_INCLUDE	QLAS_P_ORGANIZATION_INCLUDE
QLAS_P_PLACE_EXACT	QLAS_P_PLACE_EXACT
QLAS_P_PLACE_INCLUDE	QLAS_P_PLACE_INCLUDE
QLAS_P_PERSON_EXACT	QLAS_P_PERSON_EXACT
QLAS_P_PERSON_INCLUDE	QLAS_P_PERSON_INCLUDE
QLAS_P_BRAND_EXACT	QLAS_P_BRAND_EXACT
QLAS_P_BRAND_INCLUDE	QLAS_P_BRAND_INCLUDE
QLAS_P_EVENT_EXACT	QLAS_P_EVENT_EXACT
QLAS_P_EVENT_INCLUDE	QLAS_P_EVENT_INCLUDE
QLAS_P_PRODUCT_EXACT	QLAS_P_PRODUCT_EXACT
QLAS_P_PRODUCT_INCLUDE	QLAS_P_PRODUCT_INCLUDE
QLAS_P_MEDIA_EXACT	QLAS_P_MEDIA_EXACT
QLAS_P_MEDIA_INCLUDE	QLAS_P_MEDIA_INCLUDE
QLAS_P_DISH_EXACT	QLAS_P_DISH_EXACT
QLAS_P_DISH_INCLUDE	QLAS_P_DISH_INCLUDE
QLAS_P_BUSINESS_EXACT	QLAS_P_BUSINESS_EXACT
QLAS_P_BUSINESS_INCLUDE	QLAS_P_BUSINESS_INCLUDE
QLAS_P_OTHER_EXACT	QLAS_P_OTHER_EXACT
QLAS_P_OTHER_INCLUDE	QLAS_P_OTHER_INCLUDE
QLAS_P_LM_DOMAIN_AUTOS	QLAS_P_LM_DOMAIN_AUTOS
QLAS_P_LM_DOMAIN_LOCAL	QLAS_P_LM_DOMAIN_LOCAL
QLAS_P_LM_DOMAIN_PRODUCT	QLAS_P_LM_DOMAIN_PRODUCT
QLAS_P_LM_DOMAIN_RECIPE	QLAS_P_LM_DOMAIN_RECIPE
QLAS_P_LM_DOMAIN_TRAVEL	QLAS_P_LM_DOMAIN_TRAVEL
